"","jahr","schulgemeinde","schulgemeinde_code","Anzahl normal eingeschult","Anzahl verzögert eingeschult","Anzahl vorzeitig eingeschult","Anzahl irregulär eingeschult","Total Anzahl SuS","Anteil normal eingeschult","Anteil verzögert eingeschult","Anteil vorzeitig eingeschult","Anteil irregulär eingeschult"
"1",2014,"Zürich","A001",1,0,0,0,1,1,0,0,0
"2",2015,"Zürich","A001",0,1,0,1,1,0,1,0,1
"3",2016,"Zürich","A001",1,1,0,1,2,0.5,0.5,0,0.5
"5",2010,"Zürich-Uto","A012",344,2,41,43,387,0.888888888888889,0.00516795865633075,0.10594315245478,0.111111111111111
"6",2011,"Zürich-Uto","A012",359,2,39,41,400,0.8975,0.005,0.0975,0.1025
"7",2012,"Zürich-Uto","A012",420,4,27,31,451,0.931263858093126,0.00886917960088692,0.0598669623059867,0.0687361419068736
"8",2013,"Zürich-Uto","A012",428,8,33,41,469,0.912579957356077,0.0170575692963753,0.070362473347548,0.0874200426439232
"9",2014,"Zürich-Uto","A012",496,3,20,23,519,0.955684007707129,0.00578034682080925,0.0385356454720617,0.0443159922928709
"10",2015,"Zürich-Uto","A012",480,14,12,26,506,0.948616600790514,0.0276679841897233,0.0237154150197628,0.0513833992094862
"11",2016,"Zürich-Uto","A012",536,10,12,22,558,0.960573476702509,0.017921146953405,0.021505376344086,0.039426523297491
"12",2017,"Zürich-Uto","A012",508,19,8,27,535,0.949532710280374,0.0355140186915888,0.0149532710280374,0.0504672897196262
"13",2018,"Zürich-Uto","A012",602,22,3,25,627,0.960127591706539,0.0350877192982456,0.00478468899521531,0.0398724082934609
"14",2019,"Zürich-Uto","A012",596,26,0,26,622,0.958199356913183,0.0418006430868167,0,0.0418006430868167
"15",2020,"Zürich-Uto","A012",550,42,0,42,592,0.929054054054054,0.0709459459459459,0,0.0709459459459459
"16",2021,"Zürich-Uto","A012",555,38,0,38,593,0.935919055649241,0.0640809443507589,0,0.0640809443507589
"17",2022,"Zürich-Uto","A012",592,29,0,29,621,0.953301127214171,0.0466988727858293,0,0.0466988727858293
"19",2010,"Zürich-Limmattal","A022",245,2,31,33,278,0.881294964028777,0.00719424460431655,0.111510791366906,0.118705035971223
"20",2011,"Zürich-Limmattal","A022",295,3,31,34,329,0.896656534954407,0.00911854103343465,0.0942249240121581,0.103343465045593
"21",2012,"Zürich-Limmattal","A022",302,5,22,27,329,0.917933130699088,0.0151975683890578,0.0668693009118541,0.0820668693009119
"22",2013,"Zürich-Limmattal","A022",332,3,27,30,362,0.917127071823204,0.00828729281767956,0.074585635359116,0.0828729281767956
"23",2014,"Zürich-Limmattal","A022",362,7,25,32,394,0.918781725888325,0.0177664974619289,0.0634517766497462,0.0812182741116751
"24",2015,"Zürich-Limmattal","A022",374,7,12,19,393,0.951653944020356,0.0178117048346056,0.0305343511450382,0.0483460559796438
"25",2016,"Zürich-Limmattal","A022",376,3,2,5,381,0.986876640419947,0.0078740157480315,0.005249343832021,0.0131233595800525
"26",2017,"Zürich-Limmattal","A022",351,11,8,19,370,0.948648648648649,0.0297297297297297,0.0216216216216216,0.0513513513513514
"27",2018,"Zürich-Limmattal","A022",347,13,2,15,362,0.958563535911602,0.0359116022099447,0.00552486187845304,0.0414364640883978
"28",2019,"Zürich-Limmattal","A022",407,16,0,16,423,0.962174940898345,0.0378250591016548,0,0.0378250591016548
"29",2020,"Zürich-Limmattal","A022",351,28,0,28,379,0.926121372031662,0.0738786279683377,0,0.0738786279683377
"30",2021,"Zürich-Limmattal","A022",368,23,0,23,391,0.941176470588235,0.0588235294117647,0,0.0588235294117647
"31",2022,"Zürich-Limmattal","A022",320,19,0,19,339,0.943952802359882,0.056047197640118,0,0.056047197640118
"33",2010,"Zürich-Waidberg","A032",412,1,48,49,461,0.893709327548807,0.00216919739696312,0.10412147505423,0.106290672451193
"34",2011,"Zürich-Waidberg","A032",439,3,37,40,479,0.916492693110647,0.00626304801670146,0.0772442588726514,0.0835073068893528
"35",2012,"Zürich-Waidberg","A032",463,7,27,34,497,0.93158953722334,0.0140845070422535,0.0543259557344064,0.06841046277666
"36",2013,"Zürich-Waidberg","A032",497,4,26,30,527,0.943074003795066,0.00759013282732448,0.0493358633776091,0.0569259962049336
"37",2014,"Zürich-Waidberg","A032",561,10,15,25,586,0.957337883959044,0.0170648464163823,0.0255972696245734,0.0426621160409556
"38",2015,"Zürich-Waidberg","A032",562,10,13,23,585,0.960683760683761,0.0170940170940171,0.0222222222222222,0.0393162393162393
"39",2016,"Zürich-Waidberg","A032",541,12,13,25,566,0.95583038869258,0.0212014134275618,0.0229681978798587,0.0441696113074205
"40",2017,"Zürich-Waidberg","A032",560,12,10,22,582,0.962199312714777,0.0206185567010309,0.0171821305841924,0.0378006872852234
"41",2018,"Zürich-Waidberg","A032",632,24,5,29,661,0.956127080181543,0.0363086232980333,0.0075642965204236,0.0438729198184569
"42",2019,"Zürich-Waidberg","A032",618,36,0,36,654,0.944954128440367,0.055045871559633,0,0.055045871559633
"43",2020,"Zürich-Waidberg","A032",680,52,0,52,732,0.92896174863388,0.0710382513661202,0,0.0710382513661202
"44",2021,"Zürich-Waidberg","A032",614,32,0,32,646,0.95046439628483,0.0495356037151703,0,0.0495356037151703
"45",2022,"Zürich-Waidberg","A032",602,19,0,19,621,0.969404186795491,0.0305958132045089,0,0.0305958132045089
"47",2010,"Zürich-Zürichberg","A042",302,1,42,43,345,0.87536231884058,0.00289855072463768,0.121739130434783,0.12463768115942
"48",2011,"Zürich-Zürichberg","A042",291,0,48,48,339,0.858407079646018,0,0.141592920353982,0.141592920353982
"49",2012,"Zürich-Zürichberg","A042",301,4,30,34,335,0.898507462686567,0.0119402985074627,0.0895522388059701,0.101492537313433
"50",2013,"Zürich-Zürichberg","A042",333,1,26,27,360,0.925,0.00277777777777778,0.0722222222222222,0.075
"51",2014,"Zürich-Zürichberg","A042",358,8,26,34,392,0.913265306122449,0.0204081632653061,0.0663265306122449,0.086734693877551
"52",2015,"Zürich-Zürichberg","A042",345,6,12,18,363,0.950413223140496,0.0165289256198347,0.0330578512396694,0.0495867768595041
"53",2016,"Zürich-Zürichberg","A042",385,7,4,11,396,0.972222222222222,0.0176767676767677,0.0101010101010101,0.0277777777777778
"54",2017,"Zürich-Zürichberg","A042",368,7,8,15,383,0.960835509138381,0.0182767624020888,0.02088772845953,0.0391644908616188
"55",2018,"Zürich-Zürichberg","A042",424,13,3,16,440,0.963636363636364,0.0295454545454545,0.00681818181818182,0.0363636363636364
"56",2019,"Zürich-Zürichberg","A042",411,21,0,21,432,0.951388888888889,0.0486111111111111,0,0.0486111111111111
"57",2020,"Zürich-Zürichberg","A042",373,26,0,26,399,0.93483709273183,0.0651629072681704,0,0.0651629072681704
"58",2021,"Zürich-Zürichberg","A042",427,23,0,23,450,0.948888888888889,0.0511111111111111,0,0.0511111111111111
"59",2022,"Zürich-Zürichberg","A042",418,22,0,22,440,0.95,0.05,0,0.05
"61",2010,"Zürich-Glattal","A052",504,5,43,48,552,0.91304347826087,0.00905797101449275,0.0778985507246377,0.0869565217391304
"62",2011,"Zürich-Glattal","A052",493,3,35,38,531,0.928436911487759,0.00564971751412429,0.0659133709981168,0.0715630885122411
"63",2012,"Zürich-Glattal","A052",599,3,26,29,628,0.953821656050955,0.00477707006369427,0.0414012738853503,0.0461783439490446
"64",2013,"Zürich-Glattal","A052",573,6,25,31,604,0.948675496688742,0.00993377483443709,0.0413907284768212,0.0513245033112583
"65",2014,"Zürich-Glattal","A052",639,10,32,42,681,0.938325991189427,0.0146842878120411,0.0469897209985316,0.0616740088105727
"66",2015,"Zürich-Glattal","A052",658,11,18,29,687,0.957787481804949,0.0160116448326055,0.0262008733624454,0.0422125181950509
"67",2016,"Zürich-Glattal","A052",709,22,20,42,751,0.944074567243675,0.0292942743009321,0.0266311584553928,0.0559254327563249
"68",2017,"Zürich-Glattal","A052",673,24,11,35,708,0.950564971751412,0.0338983050847458,0.0155367231638418,0.0494350282485876
"69",2018,"Zürich-Glattal","A052",713,28,8,36,749,0.951935914552737,0.0373831775700935,0.0106809078771696,0.048064085447263
"70",2019,"Zürich-Glattal","A052",824,34,0,34,858,0.96037296037296,0.0396270396270396,0,0.0396270396270396
"71",2020,"Zürich-Glattal","A052",668,33,0,33,701,0.952924393723253,0.0470756062767475,0,0.0470756062767475
"72",2021,"Zürich-Glattal","A052",714,34,0,34,748,0.954545454545455,0.0454545454545455,0,0.0454545454545455
"73",2022,"Zürich-Glattal","A052",680,34,0,34,714,0.952380952380952,0.0476190476190476,0,0.0476190476190476
"75",2010,"Zürich-Letzi","A062",330,4,27,31,361,0.914127423822715,0.0110803324099723,0.074792243767313,0.0858725761772853
"76",2011,"Zürich-Letzi","A062",383,6,41,47,430,0.890697674418605,0.013953488372093,0.0953488372093023,0.109302325581395
"77",2012,"Zürich-Letzi","A062",387,5,25,30,417,0.928057553956835,0.0119904076738609,0.0599520383693046,0.0719424460431655
"78",2013,"Zürich-Letzi","A062",418,4,20,24,442,0.945701357466063,0.00904977375565611,0.0452488687782805,0.0542986425339367
"79",2014,"Zürich-Letzi","A062",430,9,11,20,450,0.955555555555556,0.02,0.0244444444444444,0.0444444444444444
"80",2015,"Zürich-Letzi","A062",497,7,12,19,516,0.963178294573643,0.0135658914728682,0.0232558139534884,0.0368217054263566
"81",2016,"Zürich-Letzi","A062",429,11,8,19,448,0.957589285714286,0.0245535714285714,0.0178571428571429,0.0424107142857143
"82",2017,"Zürich-Letzi","A062",532,36,5,41,573,0.928446771378709,0.06282722513089,0.0087260034904014,0.0715532286212914
"83",2018,"Zürich-Letzi","A062",487,21,4,25,512,0.951171875,0.041015625,0.0078125,0.048828125
"84",2019,"Zürich-Letzi","A062",510,26,0,26,536,0.951492537313433,0.0485074626865672,0,0.0485074626865672
"85",2020,"Zürich-Letzi","A062",501,46,0,46,547,0.915904936014625,0.0840950639853748,0,0.0840950639853748
"86",2021,"Zürich-Letzi","A062",556,34,0,34,590,0.942372881355932,0.0576271186440678,0,0.0576271186440678
"87",2022,"Zürich-Letzi","A062",516,33,0,33,549,0.939890710382514,0.0601092896174863,0,0.0601092896174863
"89",2010,"Zürich-Schwamendingen","A072",275,2,33,35,310,0.887096774193548,0.00645161290322581,0.106451612903226,0.112903225806452
"90",2011,"Zürich-Schwamendingen","A072",277,3,19,22,299,0.926421404682274,0.0100334448160535,0.0635451505016722,0.0735785953177258
"91",2012,"Zürich-Schwamendingen","A072",269,0,11,11,280,0.960714285714286,0,0.0392857142857143,0.0392857142857143
"92",2013,"Zürich-Schwamendingen","A072",272,4,12,16,288,0.944444444444444,0.0138888888888889,0.0416666666666667,0.0555555555555556
"93",2014,"Zürich-Schwamendingen","A072",304,2,12,14,318,0.955974842767296,0.00628930817610063,0.0377358490566038,0.0440251572327044
"94",2015,"Zürich-Schwamendingen","A072",301,5,12,17,318,0.946540880503145,0.0157232704402516,0.0377358490566038,0.0534591194968553
"95",2016,"Zürich-Schwamendingen","A072",314,8,5,13,327,0.960244648318043,0.0244648318042813,0.0152905198776758,0.0397553516819572
"96",2017,"Zürich-Schwamendingen","A072",318,4,8,12,330,0.963636363636364,0.0121212121212121,0.0242424242424242,0.0363636363636364
"97",2018,"Zürich-Schwamendingen","A072",393,13,2,15,408,0.963235294117647,0.0318627450980392,0.00490196078431373,0.0367647058823529
"98",2019,"Zürich-Schwamendingen","A072",350,10,0,10,360,0.972222222222222,0.0277777777777778,0,0.0277777777777778
"99",2020,"Zürich-Schwamendingen","A072",392,24,0,24,416,0.942307692307692,0.0576923076923077,0,0.0576923076923077
"100",2021,"Zürich-Schwamendingen","A072",352,17,0,17,369,0.953929539295393,0.046070460704607,0,0.046070460704607
"101",2022,"Zürich-Schwamendingen","A072",358,12,0,12,370,0.967567567567568,0.0324324324324324,0,0.0324324324324324
"103",2010,"Aesch","B010",6,0,0,0,6,1,0,0,0
"104",2011,"Aesch","B010",8,0,0,0,8,1,0,0,0
"105",2012,"Aesch","B010",12,0,0,0,12,1,0,0,0
"106",2013,"Aesch","B010",9,0,0,0,9,1,0,0,0
"107",2014,"Aesch","B010",12,1,0,1,13,0.923076923076923,0.0769230769230769,0,0.0769230769230769
"108",2015,"Aesch","B010",14,1,0,1,15,0.933333333333333,0.0666666666666667,0,0.0666666666666667
"109",2016,"Aesch","B010",15,1,0,1,16,0.9375,0.0625,0,0.0625
"110",2017,"Aesch","B010",12,0,0,0,12,1,0,0,0
"111",2018,"Aesch","B010",19,0,0,0,19,1,0,0,0
"112",2019,"Aesch","B010",15,3,0,3,18,0.833333333333333,0.166666666666667,0,0.166666666666667
"113",2020,"Aesch","B010",27,6,0,6,33,0.818181818181818,0.181818181818182,0,0.181818181818182
"114",2021,"Aesch","B010",21,4,0,4,25,0.84,0.16,0,0.16
"115",2022,"Aesch","B010",33,5,0,5,38,0.868421052631579,0.131578947368421,0,0.131578947368421
"117",2010,"Birmensdorf","B020",51,2,4,6,57,0.894736842105263,0.0350877192982456,0.0701754385964912,0.105263157894737
"118",2011,"Birmensdorf","B020",73,3,1,4,77,0.948051948051948,0.038961038961039,0.012987012987013,0.051948051948052
"119",2012,"Birmensdorf","B020",66,2,1,3,69,0.956521739130435,0.0289855072463768,0.0144927536231884,0.0434782608695652
"120",2013,"Birmensdorf","B020",54,1,3,4,58,0.931034482758621,0.0172413793103448,0.0517241379310345,0.0689655172413793
"121",2014,"Birmensdorf","B020",67,1,0,1,68,0.985294117647059,0.0147058823529412,0,0.0147058823529412
"122",2015,"Birmensdorf","B020",77,1,0,1,78,0.987179487179487,0.0128205128205128,0,0.0128205128205128
"123",2016,"Birmensdorf","B020",63,4,0,4,67,0.940298507462687,0.0597014925373134,0,0.0597014925373134
"124",2017,"Birmensdorf","B020",61,3,0,3,64,0.953125,0.046875,0,0.046875
"125",2018,"Birmensdorf","B020",63,12,0,12,75,0.84,0.16,0,0.16
"126",2019,"Birmensdorf","B020",75,5,0,5,80,0.9375,0.0625,0,0.0625
"127",2020,"Birmensdorf","B020",56,4,0,4,60,0.933333333333333,0.0666666666666667,0,0.0666666666666667
"128",2021,"Birmensdorf","B020",79,12,0,12,91,0.868131868131868,0.131868131868132,0,0.131868131868132
"129",2022,"Birmensdorf","B020",81,9,0,9,90,0.9,0.1,0,0.1
"131",2010,"Dietikon","B042",256,2,6,8,264,0.96969696969697,0.00757575757575758,0.0227272727272727,0.0303030303030303
"132",2011,"Dietikon","B042",236,3,2,5,241,0.979253112033195,0.012448132780083,0.00829875518672199,0.020746887966805
"133",2012,"Dietikon","B042",226,3,2,5,231,0.978354978354978,0.012987012987013,0.00865800865800866,0.0216450216450216
"134",2013,"Dietikon","B042",263,7,3,10,273,0.963369963369963,0.0256410256410256,0.010989010989011,0.0366300366300366
"135",2014,"Dietikon","B042",275,8,2,10,285,0.964912280701754,0.0280701754385965,0.00701754385964912,0.0350877192982456
"136",2015,"Dietikon","B042",274,4,3,7,281,0.97508896797153,0.0142348754448399,0.0106761565836299,0.0249110320284698
"137",2016,"Dietikon","B042",310,3,2,5,315,0.984126984126984,0.00952380952380952,0.00634920634920635,0.0158730158730159
"138",2017,"Dietikon","B042",290,8,1,9,299,0.969899665551839,0.0267558528428094,0.00334448160535117,0.0301003344481605
"139",2018,"Dietikon","B042",286,6,1,7,293,0.976109215017065,0.0204778156996587,0.00341296928327645,0.0238907849829352
"140",2019,"Dietikon","B042",298,9,0,9,307,0.970684039087948,0.0293159609120521,0,0.0293159609120521
"141",2020,"Dietikon","B042",309,15,0,15,324,0.953703703703704,0.0462962962962963,0,0.0462962962962963
"142",2021,"Dietikon","B042",293,21,0,21,314,0.93312101910828,0.0668789808917197,0,0.0668789808917197
"143",2022,"Dietikon","B042",295,13,0,13,308,0.957792207792208,0.0422077922077922,0,0.0422077922077922
"145",2010,"Oberengstringen","B052",55,0,4,4,59,0.932203389830508,0,0.0677966101694915,0.0677966101694915
"146",2011,"Oberengstringen","B052",50,2,0,2,52,0.961538461538462,0.0384615384615385,0,0.0384615384615385
"147",2012,"Oberengstringen","B052",46,2,1,3,49,0.938775510204082,0.0408163265306122,0.0204081632653061,0.0612244897959184
"148",2013,"Oberengstringen","B052",62,1,0,1,63,0.984126984126984,0.0158730158730159,0,0.0158730158730159
"149",2014,"Oberengstringen","B052",71,0,2,2,73,0.972602739726027,0,0.0273972602739726,0.0273972602739726
"150",2015,"Oberengstringen","B052",62,3,0,3,65,0.953846153846154,0.0461538461538462,0,0.0461538461538462
"151",2016,"Oberengstringen","B052",54,0,1,1,55,0.981818181818182,0,0.0181818181818182,0.0181818181818182
"152",2017,"Oberengstringen","B052",52,1,0,1,53,0.981132075471698,0.0188679245283019,0,0.0188679245283019
"153",2018,"Oberengstringen","B052",60,0,0,0,60,1,0,0,0
"154",2019,"Oberengstringen","B052",67,2,0,2,69,0.971014492753623,0.0289855072463768,0,0.0289855072463768
"155",2020,"Oberengstringen","B052",55,4,0,4,59,0.932203389830508,0.0677966101694915,0,0.0677966101694915
"156",2021,"Oberengstringen","B052",38,4,0,4,42,0.904761904761905,0.0952380952380952,0,0.0952380952380952
"157",2022,"Oberengstringen","B052",46,3,0,3,49,0.938775510204082,0.0612244897959184,0,0.0612244897959184
"159",2010,"Oetwil-Geroldswil","B060",54,0,0,0,54,1,0,0,0
"160",2011,"Oetwil-Geroldswil","B060",38,2,0,2,40,0.95,0.05,0,0.05
"161",2012,"Oetwil-Geroldswil","B060",69,4,1,5,74,0.932432432432432,0.0540540540540541,0.0135135135135135,0.0675675675675676
"162",2013,"Oetwil-Geroldswil","B060",58,0,0,0,58,1,0,0,0
"163",2014,"Oetwil-Geroldswil","B060",70,2,0,2,72,0.972222222222222,0.0277777777777778,0,0.0277777777777778
"164",2015,"Oetwil-Geroldswil","B060",68,0,0,0,68,1,0,0,0
"165",2016,"Oetwil-Geroldswil","B060",90,0,0,0,90,1,0,0,0
"166",2017,"Oetwil-Geroldswil","B060",85,1,0,1,86,0.988372093023256,0.0116279069767442,0,0.0116279069767442
"167",2018,"Oetwil-Geroldswil","B060",99,4,0,4,103,0.961165048543689,0.0388349514563107,0,0.0388349514563107
"168",2019,"Oetwil-Geroldswil","B060",77,4,0,4,81,0.950617283950617,0.0493827160493827,0,0.0493827160493827
"169",2020,"Oetwil-Geroldswil","B060",73,7,0,7,80,0.9125,0.0875,0,0.0875
"170",2021,"Oetwil-Geroldswil","B060",70,9,0,9,79,0.886075949367089,0.113924050632911,0,0.113924050632911
"171",2022,"Oetwil-Geroldswil","B060",68,5,0,5,73,0.931506849315068,0.0684931506849315,0,0.0684931506849315
"173",2010,"Schlieren","B072",144,1,2,3,147,0.979591836734694,0.00680272108843537,0.0136054421768707,0.0204081632653061
"174",2011,"Schlieren","B072",151,0,4,4,155,0.974193548387097,0,0.0258064516129032,0.0258064516129032
"175",2012,"Schlieren","B072",173,1,1,2,175,0.988571428571429,0.00571428571428571,0.00571428571428571,0.0114285714285714
"176",2013,"Schlieren","B072",172,3,1,4,176,0.977272727272727,0.0170454545454545,0.00568181818181818,0.0227272727272727
"177",2014,"Schlieren","B072",164,0,0,0,164,1,0,0,0
"178",2015,"Schlieren","B072",235,1,1,2,237,0.991561181434599,0.00421940928270042,0.00421940928270042,0.00843881856540084
"179",2016,"Schlieren","B072",177,4,0,4,181,0.977900552486188,0.0220994475138122,0,0.0220994475138122
"180",2017,"Schlieren","B072",185,2,0,2,187,0.989304812834225,0.0106951871657754,0,0.0106951871657754
"181",2018,"Schlieren","B072",201,11,0,11,212,0.94811320754717,0.0518867924528302,0,0.0518867924528302
"182",2019,"Schlieren","B072",175,3,0,3,178,0.98314606741573,0.0168539325842697,0,0.0168539325842697
"183",2020,"Schlieren","B072",199,10,0,10,209,0.952153110047847,0.0478468899521531,0,0.0478468899521531
"184",2021,"Schlieren","B072",150,12,0,12,162,0.925925925925926,0.0740740740740741,0,0.0740740740740741
"185",2022,"Schlieren","B072",183,10,0,10,193,0.948186528497409,0.0518134715025907,0,0.0518134715025907
"187",2010,"Uitikon","B082",27,0,3,3,30,0.9,0,0.1,0.1
"188",2011,"Uitikon","B082",33,1,2,3,36,0.916666666666667,0.0277777777777778,0.0555555555555556,0.0833333333333333
"189",2012,"Uitikon","B082",37,1,0,1,38,0.973684210526316,0.0263157894736842,0,0.0263157894736842
"190",2013,"Uitikon","B082",33,0,1,1,34,0.970588235294118,0,0.0294117647058824,0.0294117647058824
"191",2014,"Uitikon","B082",33,0,1,1,34,0.970588235294118,0,0.0294117647058824,0.0294117647058824
"192",2015,"Uitikon","B082",38,0,0,0,38,1,0,0,0
"193",2016,"Uitikon","B082",36,3,0,3,39,0.923076923076923,0.0769230769230769,0,0.0769230769230769
"194",2017,"Uitikon","B082",41,1,0,1,42,0.976190476190476,0.0238095238095238,0,0.0238095238095238
"195",2018,"Uitikon","B082",25,7,0,7,32,0.78125,0.21875,0,0.21875
"196",2019,"Uitikon","B082",58,4,0,4,62,0.935483870967742,0.0645161290322581,0,0.0645161290322581
"197",2020,"Uitikon","B082",51,4,0,4,55,0.927272727272727,0.0727272727272727,0,0.0727272727272727
"198",2021,"Uitikon","B082",63,6,0,6,69,0.91304347826087,0.0869565217391304,0,0.0869565217391304
"199",2022,"Uitikon","B082",48,3,0,3,51,0.941176470588235,0.0588235294117647,0,0.0588235294117647
"201",2010,"Unterengstringen","B090",27,0,2,2,29,0.931034482758621,0,0.0689655172413793,0.0689655172413793
"202",2011,"Unterengstringen","B090",35,1,0,1,36,0.972222222222222,0.0277777777777778,0,0.0277777777777778
"203",2012,"Unterengstringen","B090",23,0,2,2,25,0.92,0,0.08,0.08
"204",2013,"Unterengstringen","B090",23,0,0,0,23,1,0,0,0
"205",2014,"Unterengstringen","B090",25,0,1,1,26,0.961538461538462,0,0.0384615384615385,0.0384615384615385
"206",2015,"Unterengstringen","B090",26,2,0,2,28,0.928571428571429,0.0714285714285714,0,0.0714285714285714
"207",2016,"Unterengstringen","B090",29,1,1,2,31,0.935483870967742,0.032258064516129,0.032258064516129,0.0645161290322581
"208",2017,"Unterengstringen","B090",33,3,0,3,36,0.916666666666667,0.0833333333333333,0,0.0833333333333333
"209",2018,"Unterengstringen","B090",37,2,0,2,39,0.948717948717949,0.0512820512820513,0,0.0512820512820513
"210",2019,"Unterengstringen","B090",35,2,0,2,37,0.945945945945946,0.0540540540540541,0,0.0540540540540541
"211",2020,"Unterengstringen","B090",39,4,0,4,43,0.906976744186046,0.0930232558139535,0,0.0930232558139535
"212",2021,"Unterengstringen","B090",45,4,0,4,49,0.918367346938776,0.0816326530612245,0,0.0816326530612245
"213",2022,"Unterengstringen","B090",46,4,0,4,50,0.92,0.08,0,0.08
"215",2010,"Urdorf","B102",89,0,0,0,89,1,0,0,0
"216",2011,"Urdorf","B102",87,0,1,1,88,0.988636363636364,0,0.0113636363636364,0.0113636363636364
"217",2012,"Urdorf","B102",80,5,1,6,86,0.930232558139535,0.0581395348837209,0.0116279069767442,0.0697674418604651
"218",2013,"Urdorf","B102",98,3,2,5,103,0.951456310679612,0.029126213592233,0.0194174757281553,0.0485436893203883
"219",2014,"Urdorf","B102",106,0,0,0,106,1,0,0,0
"220",2015,"Urdorf","B102",96,4,2,6,102,0.941176470588235,0.0392156862745098,0.0196078431372549,0.0588235294117647
"221",2016,"Urdorf","B102",111,4,1,5,116,0.956896551724138,0.0344827586206897,0.00862068965517241,0.0431034482758621
"222",2017,"Urdorf","B102",101,6,0,6,107,0.94392523364486,0.0560747663551402,0,0.0560747663551402
"223",2018,"Urdorf","B102",91,8,0,8,99,0.919191919191919,0.0808080808080808,0,0.0808080808080808
"224",2019,"Urdorf","B102",96,7,0,7,103,0.932038834951456,0.0679611650485437,0,0.0679611650485437
"225",2020,"Urdorf","B102",105,9,0,9,114,0.921052631578947,0.0789473684210526,0,0.0789473684210526
"226",2021,"Urdorf","B102",94,10,0,10,104,0.903846153846154,0.0961538461538462,0,0.0961538461538462
"227",2022,"Urdorf","B102",77,17,0,17,94,0.819148936170213,0.180851063829787,0,0.180851063829787
"229",2010,"Weiningen","B110",41,1,0,1,42,0.976190476190476,0.0238095238095238,0,0.0238095238095238
"230",2011,"Weiningen","B110",42,1,2,3,45,0.933333333333333,0.0222222222222222,0.0444444444444444,0.0666666666666667
"231",2012,"Weiningen","B110",37,0,0,0,37,1,0,0,0
"232",2013,"Weiningen","B110",43,0,0,0,43,1,0,0,0
"233",2014,"Weiningen","B110",51,1,0,1,52,0.980769230769231,0.0192307692307692,0,0.0192307692307692
"234",2015,"Weiningen","B110",55,0,1,1,56,0.982142857142857,0,0.0178571428571429,0.0178571428571429
"235",2016,"Weiningen","B110",37,0,1,1,38,0.973684210526316,0,0.0263157894736842,0.0263157894736842
"236",2017,"Weiningen","B110",46,1,0,1,47,0.978723404255319,0.0212765957446809,0,0.0212765957446809
"237",2018,"Weiningen","B110",47,1,0,1,48,0.979166666666667,0.0208333333333333,0,0.0208333333333333
"238",2019,"Weiningen","B110",55,3,0,3,58,0.948275862068966,0.0517241379310345,0,0.0517241379310345
"239",2020,"Weiningen","B110",43,3,0,3,46,0.934782608695652,0.0652173913043478,0,0.0652173913043478
"240",2021,"Weiningen","B110",47,3,0,3,50,0.94,0.06,0,0.06
"241",2022,"Weiningen","B110",40,2,0,2,42,0.952380952380952,0.0476190476190476,0,0.0476190476190476
"243",2010,"Aeugst a.A.","C010",15,1,1,2,17,0.882352941176471,0.0588235294117647,0.0588235294117647,0.117647058823529
"244",2011,"Aeugst a.A.","C010",10,0,1,1,11,0.909090909090909,0,0.0909090909090909,0.0909090909090909
"245",2012,"Aeugst a.A.","C010",25,0,1,1,26,0.961538461538462,0,0.0384615384615385,0.0384615384615385
"246",2013,"Aeugst a.A.","C010",21,0,0,0,21,1,0,0,0
"247",2014,"Aeugst a.A.","C010",18,0,1,1,19,0.947368421052632,0,0.0526315789473684,0.0526315789473684
"248",2015,"Aeugst a.A.","C010",19,0,0,0,19,1,0,0,0
"249",2016,"Aeugst a.A.","C010",20,0,0,0,20,1,0,0,0
"250",2017,"Aeugst a.A.","C010",16,1,0,1,17,0.941176470588235,0.0588235294117647,0,0.0588235294117647
"251",2018,"Aeugst a.A.","C010",22,0,0,0,22,1,0,0,0
"252",2019,"Aeugst a.A.","C010",18,0,0,0,18,1,0,0,0
"253",2020,"Aeugst a.A.","C010",15,1,0,1,16,0.9375,0.0625,0,0.0625
"254",2021,"Aeugst a.A.","C010",19,0,0,0,19,1,0,0,0
"255",2022,"Aeugst a.A.","C010",17,0,0,0,17,1,0,0,0
"257",2010,"Affoltern a.A.","C020",90,1,2,3,93,0.967741935483871,0.010752688172043,0.021505376344086,0.032258064516129
"258",2011,"Affoltern a.A.","C020",114,1,1,2,116,0.982758620689655,0.00862068965517241,0.00862068965517241,0.0172413793103448
"259",2012,"Affoltern a.A.","C020",87,0,0,0,87,1,0,0,0
"260",2013,"Affoltern a.A.","C020",101,2,1,3,104,0.971153846153846,0.0192307692307692,0.00961538461538462,0.0288461538461538
"261",2014,"Affoltern a.A.","C020",108,3,0,3,111,0.972972972972973,0.027027027027027,0,0.027027027027027
"262",2015,"Affoltern a.A.","C020",102,5,0,5,107,0.953271028037383,0.0467289719626168,0,0.0467289719626168
"263",2016,"Affoltern a.A.","C020",113,7,1,8,121,0.933884297520661,0.0578512396694215,0.00826446280991736,0.0661157024793388
"264",2017,"Affoltern a.A.","C020",94,2,0,2,96,0.979166666666667,0.0208333333333333,0,0.0208333333333333
"265",2018,"Affoltern a.A.","C020",114,4,0,4,118,0.966101694915254,0.0338983050847458,0,0.0338983050847458
"266",2019,"Affoltern a.A.","C020",118,7,0,7,125,0.944,0.056,0,0.056
"267",2020,"Affoltern a.A.","C020",104,12,0,12,116,0.896551724137931,0.103448275862069,0,0.103448275862069
"268",2021,"Affoltern a.A.","C020",97,11,0,11,108,0.898148148148148,0.101851851851852,0,0.101851851851852
"269",2022,"Affoltern a.A.","C020",106,12,0,12,118,0.898305084745763,0.101694915254237,0,0.101694915254237
"271",2010,"Bonstetten","C050",68,1,1,2,70,0.971428571428571,0.0142857142857143,0.0142857142857143,0.0285714285714286
"272",2011,"Bonstetten","C050",64,3,0,3,67,0.955223880597015,0.0447761194029851,0,0.0447761194029851
"273",2012,"Bonstetten","C050",63,5,1,6,69,0.91304347826087,0.072463768115942,0.0144927536231884,0.0869565217391304
"274",2013,"Bonstetten","C050",74,4,2,6,80,0.925,0.05,0.025,0.075
"275",2014,"Bonstetten","C050",63,6,0,6,69,0.91304347826087,0.0869565217391304,0,0.0869565217391304
"276",2015,"Bonstetten","C050",58,8,0,8,66,0.878787878787879,0.121212121212121,0,0.121212121212121
"277",2016,"Bonstetten","C050",69,6,0,6,75,0.92,0.08,0,0.08
"278",2017,"Bonstetten","C050",59,5,0,5,64,0.921875,0.078125,0,0.078125
"279",2018,"Bonstetten","C050",64,5,0,5,69,0.927536231884058,0.072463768115942,0,0.072463768115942
"280",2019,"Bonstetten","C050",58,7,0,7,65,0.892307692307692,0.107692307692308,0,0.107692307692308
"281",2020,"Bonstetten","C050",48,12,0,12,60,0.8,0.2,0,0.2
"282",2021,"Bonstetten","C050",62,10,2,12,74,0.837837837837838,0.135135135135135,0.027027027027027,0.162162162162162
"283",2022,"Bonstetten","C050",54,3,0,3,57,0.947368421052632,0.0526315789473684,0,0.0526315789473684
"285",2010,"Hausen a.A.","C070",36,1,0,1,37,0.972972972972973,0.027027027027027,0,0.027027027027027
"286",2011,"Hausen a.A.","C070",42,2,0,2,44,0.954545454545455,0.0454545454545455,0,0.0454545454545455
"287",2012,"Hausen a.A.","C070",40,2,0,2,42,0.952380952380952,0.0476190476190476,0,0.0476190476190476
"288",2013,"Hausen a.A.","C070",37,0,1,1,38,0.973684210526316,0,0.0263157894736842,0.0263157894736842
"289",2014,"Hausen a.A.","C070",43,2,0,2,45,0.955555555555556,0.0444444444444444,0,0.0444444444444444
"290",2015,"Hausen a.A.","C070",36,1,0,1,37,0.972972972972973,0.027027027027027,0,0.027027027027027
"291",2016,"Hausen a.A.","C070",25,3,0,3,28,0.892857142857143,0.107142857142857,0,0.107142857142857
"292",2017,"Hausen a.A.","C070",36,3,1,4,40,0.9,0.075,0.025,0.1
"293",2018,"Hausen a.A.","C070",29,5,2,7,36,0.805555555555556,0.138888888888889,0.0555555555555556,0.194444444444444
"294",2019,"Hausen a.A.","C070",44,3,0,3,47,0.936170212765957,0.0638297872340425,0,0.0638297872340425
"295",2020,"Hausen a.A.","C070",29,6,0,6,35,0.828571428571429,0.171428571428571,0,0.171428571428571
"296",2021,"Hausen a.A.","C070",42,3,0,3,45,0.933333333333333,0.0666666666666667,0,0.0666666666666667
"297",2022,"Hausen a.A.","C070",22,8,0,8,30,0.733333333333333,0.266666666666667,0,0.266666666666667
"299",2010,"Hedingen","C092",42,5,2,7,49,0.857142857142857,0.102040816326531,0.0408163265306122,0.142857142857143
"300",2011,"Hedingen","C092",33,1,0,1,34,0.970588235294118,0.0294117647058824,0,0.0294117647058824
"301",2012,"Hedingen","C092",37,1,1,2,39,0.948717948717949,0.0256410256410256,0.0256410256410256,0.0512820512820513
"302",2013,"Hedingen","C092",31,1,0,1,32,0.96875,0.03125,0,0.03125
"303",2014,"Hedingen","C092",32,0,0,0,32,1,0,0,0
"304",2015,"Hedingen","C092",42,2,0,2,44,0.954545454545455,0.0454545454545455,0,0.0454545454545455
"305",2016,"Hedingen","C092",33,3,1,4,37,0.891891891891892,0.0810810810810811,0.027027027027027,0.108108108108108
"306",2017,"Hedingen","C092",45,3,1,4,49,0.918367346938776,0.0612244897959184,0.0204081632653061,0.0816326530612245
"307",2018,"Hedingen","C092",41,1,0,1,42,0.976190476190476,0.0238095238095238,0,0.0238095238095238
"308",2019,"Hedingen","C092",36,4,0,4,40,0.9,0.1,0,0.1
"309",2020,"Hedingen","C092",32,5,0,5,37,0.864864864864865,0.135135135135135,0,0.135135135135135
"310",2021,"Hedingen","C092",30,4,0,4,34,0.882352941176471,0.117647058823529,0,0.117647058823529
"311",2022,"Hedingen","C092",43,1,0,1,44,0.977272727272727,0.0227272727272727,0,0.0227272727272727
"313",2010,"Kappel a.A.","C100",10,0,1,1,11,0.909090909090909,0,0.0909090909090909,0.0909090909090909
"314",2011,"Kappel a.A.","C100",12,0,1,1,13,0.923076923076923,0,0.0769230769230769,0.0769230769230769
"315",2012,"Kappel a.A.","C100",7,1,1,2,9,0.777777777777778,0.111111111111111,0.111111111111111,0.222222222222222
"316",2013,"Kappel a.A.","C100",19,0,0,0,19,1,0,0,0
"317",2014,"Kappel a.A.","C100",9,0,1,1,10,0.9,0,0.1,0.1
"318",2015,"Kappel a.A.","C100",15,0,0,0,15,1,0,0,0
"319",2016,"Kappel a.A.","C100",15,0,1,1,16,0.9375,0,0.0625,0.0625
"320",2017,"Kappel a.A.","C100",16,0,1,1,17,0.941176470588235,0,0.0588235294117647,0.0588235294117647
"321",2018,"Kappel a.A.","C100",16,2,1,3,19,0.842105263157895,0.105263157894737,0.0526315789473684,0.157894736842105
"322",2019,"Kappel a.A.","C100",13,1,0,1,14,0.928571428571429,0.0714285714285714,0,0.0714285714285714
"323",2020,"Kappel a.A.","C100",16,1,0,1,17,0.941176470588235,0.0588235294117647,0,0.0588235294117647
"324",2021,"Kappel a.A.","C100",13,3,0,3,16,0.8125,0.1875,0,0.1875
"325",2022,"Kappel a.A.","C100",12,1,0,1,13,0.923076923076923,0.0769230769230769,0,0.0769230769230769
"327",2010,"Knonau","C110",17,2,3,5,22,0.772727272727273,0.0909090909090909,0.136363636363636,0.227272727272727
"328",2011,"Knonau","C110",27,0,1,1,28,0.964285714285714,0,0.0357142857142857,0.0357142857142857
"329",2012,"Knonau","C110",24,0,1,1,25,0.96,0,0.04,0.04
"330",2013,"Knonau","C110",30,1,0,1,31,0.967741935483871,0.032258064516129,0,0.032258064516129
"331",2014,"Knonau","C110",24,0,2,2,26,0.923076923076923,0,0.0769230769230769,0.0769230769230769
"332",2015,"Knonau","C110",33,1,0,1,34,0.970588235294118,0.0294117647058824,0,0.0294117647058824
"333",2016,"Knonau","C110",26,1,0,1,27,0.962962962962963,0.037037037037037,0,0.037037037037037
"334",2017,"Knonau","C110",31,2,0,2,33,0.939393939393939,0.0606060606060606,0,0.0606060606060606
"335",2018,"Knonau","C110",34,6,0,6,40,0.85,0.15,0,0.15
"336",2019,"Knonau","C110",29,4,0,4,33,0.878787878787879,0.121212121212121,0,0.121212121212121
"337",2020,"Knonau","C110",34,2,0,2,36,0.944444444444444,0.0555555555555556,0,0.0555555555555556
"338",2021,"Knonau","C110",35,13,0,13,48,0.729166666666667,0.270833333333333,0,0.270833333333333
"339",2022,"Knonau","C110",35,0,0,0,35,1,0,0,0
"341",2010,"Maschwanden","C120",10,0,1,1,11,0.909090909090909,0,0.0909090909090909,0.0909090909090909
"342",2011,"Maschwanden","C120",6,0,0,0,6,1,0,0,0
"343",2012,"Maschwanden","C120",8,0,0,0,8,1,0,0,0
"344",2013,"Maschwanden","C120",8,0,0,0,8,1,0,0,0
"345",2014,"Maschwanden","C120",5,1,1,2,7,0.714285714285714,0.142857142857143,0.142857142857143,0.285714285714286
"346",2015,"Maschwanden","C120",7,2,0,2,9,0.777777777777778,0.222222222222222,0,0.222222222222222
"347",2016,"Maschwanden","C120",8,0,0,0,8,1,0,0,0
"348",2017,"Maschwanden","C120",13,0,0,0,13,1,0,0,0
"349",2018,"Maschwanden","C120",8,0,0,0,8,1,0,0,0
"350",2019,"Maschwanden","C120",7,1,0,1,8,0.875,0.125,0,0.125
"351",2020,"Maschwanden","C120",6,2,0,2,8,0.75,0.25,0,0.25
"352",2021,"Maschwanden","C120",11,2,0,2,13,0.846153846153846,0.153846153846154,0,0.153846153846154
"353",2022,"Maschwanden","C120",4,1,0,1,5,0.8,0.2,0,0.2
"355",2010,"Mettmenstetten","C130",41,1,1,2,43,0.953488372093023,0.0232558139534884,0.0232558139534884,0.0465116279069767
"356",2011,"Mettmenstetten","C130",45,4,0,4,49,0.918367346938776,0.0816326530612245,0,0.0816326530612245
"357",2012,"Mettmenstetten","C130",36,3,1,4,40,0.9,0.075,0.025,0.1
"358",2013,"Mettmenstetten","C130",40,1,3,4,44,0.909090909090909,0.0227272727272727,0.0681818181818182,0.0909090909090909
"359",2014,"Mettmenstetten","C130",52,1,3,4,56,0.928571428571429,0.0178571428571429,0.0535714285714286,0.0714285714285714
"360",2015,"Mettmenstetten","C130",53,1,1,2,55,0.963636363636364,0.0181818181818182,0.0181818181818182,0.0363636363636364
"361",2016,"Mettmenstetten","C130",43,6,1,7,50,0.86,0.12,0.02,0.14
"362",2017,"Mettmenstetten","C130",63,7,0,7,70,0.9,0.1,0,0.1
"363",2018,"Mettmenstetten","C130",57,5,0,5,62,0.919354838709677,0.0806451612903226,0,0.0806451612903226
"364",2019,"Mettmenstetten","C130",67,6,0,6,73,0.917808219178082,0.0821917808219178,0,0.0821917808219178
"365",2020,"Mettmenstetten","C130",58,6,0,6,64,0.90625,0.09375,0,0.09375
"366",2021,"Mettmenstetten","C130",77,7,0,7,84,0.916666666666667,0.0833333333333333,0,0.0833333333333333
"367",2022,"Mettmenstetten","C130",71,4,0,4,75,0.946666666666667,0.0533333333333333,0,0.0533333333333333
"369",2010,"Obfelden","C150",47,0,3,3,50,0.94,0,0.06,0.06
"370",2011,"Obfelden","C150",47,2,1,3,50,0.94,0.04,0.02,0.06
"371",2012,"Obfelden","C150",38,1,1,2,40,0.95,0.025,0.025,0.05
"372",2013,"Obfelden","C150",69,2,3,5,74,0.932432432432432,0.027027027027027,0.0405405405405405,0.0675675675675676
"373",2014,"Obfelden","C150",50,0,0,0,50,1,0,0,0
"374",2015,"Obfelden","C150",57,2,1,3,60,0.95,0.0333333333333333,0.0166666666666667,0.05
"375",2016,"Obfelden","C150",58,7,1,8,66,0.878787878787879,0.106060606060606,0.0151515151515152,0.121212121212121
"376",2017,"Obfelden","C150",51,2,2,4,55,0.927272727272727,0.0363636363636364,0.0363636363636364,0.0727272727272727
"377",2018,"Obfelden","C150",70,10,1,11,81,0.864197530864197,0.123456790123457,0.0123456790123457,0.135802469135802
"378",2019,"Obfelden","C150",64,3,0,3,67,0.955223880597015,0.0447761194029851,0,0.0447761194029851
"379",2020,"Obfelden","C150",68,10,0,10,78,0.871794871794872,0.128205128205128,0,0.128205128205128
"380",2021,"Obfelden","C150",75,8,0,8,83,0.903614457831325,0.0963855421686747,0,0.0963855421686747
"381",2022,"Obfelden","C150",65,6,0,6,71,0.915492957746479,0.0845070422535211,0,0.0845070422535211
"383",2010,"Ottenbach","C170",16,1,0,1,17,0.941176470588235,0.0588235294117647,0,0.0588235294117647
"384",2011,"Ottenbach","C170",19,0,0,0,19,1,0,0,0
"385",2012,"Ottenbach","C170",20,1,0,1,21,0.952380952380952,0.0476190476190476,0,0.0476190476190476
"386",2013,"Ottenbach","C170",30,1,1,2,32,0.9375,0.03125,0.03125,0.0625
"387",2014,"Ottenbach","C170",21,1,1,2,23,0.91304347826087,0.0434782608695652,0.0434782608695652,0.0869565217391304
"388",2015,"Ottenbach","C170",17,3,1,4,21,0.80952380952381,0.142857142857143,0.0476190476190476,0.19047619047619
"389",2016,"Ottenbach","C170",26,3,0,3,29,0.896551724137931,0.103448275862069,0,0.103448275862069
"390",2017,"Ottenbach","C170",37,2,0,2,39,0.948717948717949,0.0512820512820513,0,0.0512820512820513
"391",2018,"Ottenbach","C170",27,0,1,1,28,0.964285714285714,0,0.0357142857142857,0.0357142857142857
"392",2019,"Ottenbach","C170",22,3,0,3,25,0.88,0.12,0,0.12
"393",2020,"Ottenbach","C170",28,1,0,1,29,0.96551724137931,0.0344827586206897,0,0.0344827586206897
"394",2021,"Ottenbach","C170",15,2,0,2,17,0.882352941176471,0.117647058823529,0,0.117647058823529
"395",2022,"Ottenbach","C170",24,2,0,2,26,0.923076923076923,0.0769230769230769,0,0.0769230769230769
"397",2010,"Rifferswil","C180",14,0,2,2,16,0.875,0,0.125,0.125
"398",2011,"Rifferswil","C180",15,0,1,1,16,0.9375,0,0.0625,0.0625
"399",2012,"Rifferswil","C180",14,0,1,1,15,0.933333333333333,0,0.0666666666666667,0.0666666666666667
"400",2013,"Rifferswil","C180",17,0,0,0,17,1,0,0,0
"401",2014,"Rifferswil","C180",17,0,0,0,17,1,0,0,0
"402",2015,"Rifferswil","C180",10,2,0,2,12,0.833333333333333,0.166666666666667,0,0.166666666666667
"403",2016,"Rifferswil","C180",24,1,0,1,25,0.96,0.04,0,0.04
"404",2017,"Rifferswil","C180",15,2,0,2,17,0.882352941176471,0.117647058823529,0,0.117647058823529
"405",2018,"Rifferswil","C180",13,0,0,0,13,1,0,0,0
"406",2019,"Rifferswil","C180",15,3,0,3,18,0.833333333333333,0.166666666666667,0,0.166666666666667
"407",2020,"Rifferswil","C180",13,1,0,1,14,0.928571428571429,0.0714285714285714,0,0.0714285714285714
"408",2021,"Rifferswil","C180",9,0,0,0,9,1,0,0,0
"409",2022,"Rifferswil","C180",6,1,0,1,7,0.857142857142857,0.142857142857143,0,0.142857142857143
"411",2010,"Stallikon","C190",15,0,0,0,15,1,0,0,0
"412",2011,"Stallikon","C190",29,0,0,0,29,1,0,0,0
"413",2012,"Stallikon","C190",48,0,0,0,48,1,0,0,0
"414",2013,"Stallikon","C190",26,0,0,0,26,1,0,0,0
"415",2014,"Stallikon","C190",38,1,0,1,39,0.974358974358974,0.0256410256410256,0,0.0256410256410256
"416",2015,"Stallikon","C190",32,1,0,1,33,0.96969696969697,0.0303030303030303,0,0.0303030303030303
"417",2016,"Stallikon","C190",33,0,0,0,33,1,0,0,0
"418",2017,"Stallikon","C190",57,3,1,4,61,0.934426229508197,0.0491803278688525,0.0163934426229508,0.0655737704918033
"419",2018,"Stallikon","C190",43,3,0,3,46,0.934782608695652,0.0652173913043478,0,0.0652173913043478
"420",2019,"Stallikon","C190",50,1,0,1,51,0.980392156862745,0.0196078431372549,0,0.0196078431372549
"421",2020,"Stallikon","C190",51,5,0,5,56,0.910714285714286,0.0892857142857143,0,0.0892857142857143
"422",2021,"Stallikon","C190",43,5,0,5,48,0.895833333333333,0.104166666666667,0,0.104166666666667
"423",2022,"Stallikon","C190",32,4,0,4,36,0.888888888888889,0.111111111111111,0,0.111111111111111
"425",2010,"Wettswil a.A.","C200",59,5,0,5,64,0.921875,0.078125,0,0.078125
"426",2011,"Wettswil a.A.","C200",48,1,0,1,49,0.979591836734694,0.0204081632653061,0,0.0204081632653061
"427",2012,"Wettswil a.A.","C200",58,4,0,4,62,0.935483870967742,0.0645161290322581,0,0.0645161290322581
"428",2013,"Wettswil a.A.","C200",47,1,0,1,48,0.979166666666667,0.0208333333333333,0,0.0208333333333333
"429",2014,"Wettswil a.A.","C200",64,2,0,2,66,0.96969696969697,0.0303030303030303,0,0.0303030303030303
"430",2015,"Wettswil a.A.","C200",63,1,1,2,65,0.969230769230769,0.0153846153846154,0.0153846153846154,0.0307692307692308
"431",2016,"Wettswil a.A.","C200",62,2,0,2,64,0.96875,0.03125,0,0.03125
"432",2017,"Wettswil a.A.","C200",74,3,0,3,77,0.961038961038961,0.038961038961039,0,0.038961038961039
"433",2018,"Wettswil a.A.","C200",56,3,0,3,59,0.949152542372881,0.0508474576271186,0,0.0508474576271186
"434",2019,"Wettswil a.A.","C200",69,8,0,8,77,0.896103896103896,0.103896103896104,0,0.103896103896104
"435",2020,"Wettswil a.A.","C200",58,5,0,5,63,0.920634920634921,0.0793650793650794,0,0.0793650793650794
"436",2021,"Wettswil a.A.","C200",61,3,0,3,64,0.953125,0.046875,0,0.046875
"437",2022,"Wettswil a.A.","C200",42,7,0,7,49,0.857142857142857,0.142857142857143,0,0.142857142857143
"439",2010,"Adliswil","D012",144,1,7,8,152,0.947368421052632,0.00657894736842105,0.0460526315789474,0.0526315789473684
"440",2011,"Adliswil","D012",125,2,11,13,138,0.905797101449275,0.0144927536231884,0.0797101449275362,0.0942028985507246
"441",2012,"Adliswil","D012",153,1,7,8,161,0.950310559006211,0.0062111801242236,0.0434782608695652,0.0496894409937888
"442",2013,"Adliswil","D012",171,0,10,10,181,0.94475138121547,0,0.0552486187845304,0.0552486187845304
"443",2014,"Adliswil","D012",174,1,4,5,179,0.972067039106145,0.00558659217877095,0.0223463687150838,0.0279329608938547
"444",2015,"Adliswil","D012",172,3,5,8,180,0.955555555555556,0.0166666666666667,0.0277777777777778,0.0444444444444444
"445",2016,"Adliswil","D012",182,4,4,8,190,0.957894736842105,0.0210526315789474,0.0210526315789474,0.0421052631578947
"446",2017,"Adliswil","D012",195,4,2,6,201,0.970149253731343,0.0199004975124378,0.00995024875621891,0.0298507462686567
"447",2018,"Adliswil","D012",209,3,1,4,213,0.981220657276995,0.0140845070422535,0.00469483568075117,0.0187793427230047
"448",2019,"Adliswil","D012",211,6,0,6,217,0.972350230414747,0.0276497695852535,0,0.0276497695852535
"449",2020,"Adliswil","D012",168,5,0,5,173,0.971098265895954,0.0289017341040462,0,0.0289017341040462
"450",2021,"Adliswil","D012",180,3,0,3,183,0.983606557377049,0.0163934426229508,0,0.0163934426229508
"451",2022,"Adliswil","D012",198,1,0,1,199,0.994974874371859,0.0050251256281407,0,0.0050251256281407
"453",2010,"Hirzel","D022",28,0,0,0,28,1,0,0,0
"454",2011,"Hirzel","D022",31,0,0,0,31,1,0,0,0
"455",2012,"Hirzel","D022",26,1,0,1,27,0.962962962962963,0.037037037037037,0,0.037037037037037
"456",2013,"Hirzel","D022",22,1,2,3,25,0.88,0.04,0.08,0.12
"457",2014,"Hirzel","D022",26,0,0,0,26,1,0,0,0
"458",2015,"Hirzel","D022",23,0,0,0,23,1,0,0,0
"459",2016,"Hirzel","D022",21,2,2,4,25,0.84,0.08,0.08,0.16
"460",2017,"Hirzel","D022",21,1,2,3,24,0.875,0.0416666666666667,0.0833333333333333,0.125
"462",2010,"Horgen","D032",156,2,8,10,166,0.939759036144578,0.0120481927710843,0.0481927710843374,0.0602409638554217
"463",2011,"Horgen","D032",153,5,5,10,163,0.938650306748466,0.0306748466257669,0.0306748466257669,0.0613496932515337
"464",2012,"Horgen","D032",194,3,1,4,198,0.97979797979798,0.0151515151515152,0.00505050505050505,0.0202020202020202
"465",2013,"Horgen","D032",150,1,4,5,155,0.967741935483871,0.00645161290322581,0.0258064516129032,0.032258064516129
"466",2014,"Horgen","D032",201,7,2,9,210,0.957142857142857,0.0333333333333333,0.00952380952380952,0.0428571428571429
"467",2015,"Horgen","D032",188,4,2,6,194,0.969072164948454,0.0206185567010309,0.0103092783505155,0.0309278350515464
"468",2016,"Horgen","D032",189,4,0,4,193,0.979274611398964,0.0207253886010363,0,0.0207253886010363
"469",2017,"Horgen","D032",202,4,2,6,208,0.971153846153846,0.0192307692307692,0.00961538461538462,0.0288461538461538
"470",2018,"Horgen","D033",247,10,0,10,257,0.961089494163424,0.0389105058365759,0,0.0389105058365759
"471",2019,"Horgen","D033",239,4,0,4,243,0.983539094650206,0.0164609053497942,0,0.0164609053497942
"472",2020,"Horgen","D033",217,13,0,13,230,0.943478260869565,0.0565217391304348,0,0.0565217391304348
"473",2021,"Horgen","D033",227,9,0,9,236,0.961864406779661,0.038135593220339,0,0.038135593220339
"474",2022,"Horgen","D033",220,13,0,13,233,0.944206008583691,0.055793991416309,0,0.055793991416309
"476",2010,"Hütten","D040",12,1,0,1,13,0.923076923076923,0.0769230769230769,0,0.0769230769230769
"477",2011,"Hütten","D040",10,0,0,0,10,1,0,0,0
"478",2012,"Hütten","D040",11,0,2,2,13,0.846153846153846,0,0.153846153846154,0.153846153846154
"479",2013,"Hütten","D040",8,0,0,0,8,1,0,0,0
"480",2014,"Hütten","D040",11,0,0,0,11,1,0,0,0
"481",2015,"Hütten","D040",8,0,0,0,8,1,0,0,0
"482",2016,"Hütten","D040",8,1,0,1,9,0.888888888888889,0.111111111111111,0,0.111111111111111
"483",2017,"Hütten","D040",5,0,0,0,5,1,0,0,0
"484",2018,"Hütten","D040",11,0,0,0,11,1,0,0,0
"486",2010,"Kilchberg","D052",40,0,5,5,45,0.888888888888889,0,0.111111111111111,0.111111111111111
"487",2011,"Kilchberg","D052",49,1,8,9,58,0.844827586206897,0.0172413793103448,0.137931034482759,0.155172413793103
"488",2012,"Kilchberg","D052",56,0,5,5,61,0.918032786885246,0,0.0819672131147541,0.0819672131147541
"489",2013,"Kilchberg","D052",51,1,1,2,53,0.962264150943396,0.0188679245283019,0.0188679245283019,0.0377358490566038
"490",2014,"Kilchberg","D052",61,1,5,6,67,0.91044776119403,0.0149253731343284,0.0746268656716418,0.0895522388059701
"491",2015,"Kilchberg","D052",54,4,3,7,61,0.885245901639344,0.0655737704918033,0.0491803278688525,0.114754098360656
"492",2016,"Kilchberg","D052",73,3,1,4,77,0.948051948051948,0.038961038961039,0.012987012987013,0.051948051948052
"493",2017,"Kilchberg","D052",60,1,0,1,61,0.983606557377049,0.0163934426229508,0,0.0163934426229508
"494",2018,"Kilchberg","D052",60,2,3,5,65,0.923076923076923,0.0307692307692308,0.0461538461538462,0.0769230769230769
"495",2019,"Kilchberg","D052",86,8,1,9,95,0.905263157894737,0.0842105263157895,0.0105263157894737,0.0947368421052632
"496",2020,"Kilchberg","D052",81,4,0,4,85,0.952941176470588,0.0470588235294118,0,0.0470588235294118
"497",2021,"Kilchberg","D052",83,4,0,4,87,0.954022988505747,0.0459770114942529,0,0.0459770114942529
"498",2022,"Kilchberg","D052",85,8,0,8,93,0.913978494623656,0.0860215053763441,0,0.0860215053763441
"500",2010,"Langnau a.A.","D062",55,2,3,5,60,0.916666666666667,0.0333333333333333,0.05,0.0833333333333333
"501",2011,"Langnau a.A.","D062",73,2,2,4,77,0.948051948051948,0.025974025974026,0.025974025974026,0.051948051948052
"502",2012,"Langnau a.A.","D062",72,0,1,1,73,0.986301369863014,0,0.0136986301369863,0.0136986301369863
"503",2013,"Langnau a.A.","D062",74,1,0,1,75,0.986666666666667,0.0133333333333333,0,0.0133333333333333
"504",2014,"Langnau a.A.","D062",81,1,1,2,83,0.975903614457831,0.0120481927710843,0.0120481927710843,0.0240963855421687
"505",2015,"Langnau a.A.","D062",63,0,0,0,63,1,0,0,0
"506",2016,"Langnau a.A.","D062",62,4,2,6,68,0.911764705882353,0.0588235294117647,0.0294117647058824,0.0882352941176471
"507",2017,"Langnau a.A.","D062",73,3,0,3,76,0.960526315789474,0.0394736842105263,0,0.0394736842105263
"508",2018,"Langnau a.A.","D062",80,4,0,4,84,0.952380952380952,0.0476190476190476,0,0.0476190476190476
"509",2019,"Langnau a.A.","D062",76,7,0,7,83,0.91566265060241,0.0843373493975904,0,0.0843373493975904
"510",2020,"Langnau a.A.","D062",69,3,0,3,72,0.958333333333333,0.0416666666666667,0,0.0416666666666667
"511",2021,"Langnau a.A.","D062",96,7,0,7,103,0.932038834951456,0.0679611650485437,0,0.0679611650485437
"512",2022,"Langnau a.A.","D062",72,8,0,8,80,0.9,0.1,0,0.1
"514",2010,"Oberrieden","D072",30,0,2,2,32,0.9375,0,0.0625,0.0625
"515",2011,"Oberrieden","D072",24,0,1,1,25,0.96,0,0.04,0.04
"516",2012,"Oberrieden","D072",49,0,0,0,49,1,0,0,0
"517",2013,"Oberrieden","D072",51,0,1,1,52,0.980769230769231,0,0.0192307692307692,0.0192307692307692
"518",2014,"Oberrieden","D072",45,0,0,0,45,1,0,0,0
"519",2015,"Oberrieden","D072",30,4,0,4,34,0.882352941176471,0.117647058823529,0,0.117647058823529
"520",2016,"Oberrieden","D072",39,0,0,0,39,1,0,0,0
"521",2017,"Oberrieden","D072",46,1,0,1,47,0.978723404255319,0.0212765957446809,0,0.0212765957446809
"522",2018,"Oberrieden","D072",35,1,0,1,36,0.972222222222222,0.0277777777777778,0,0.0277777777777778
"523",2019,"Oberrieden","D072",36,3,0,3,39,0.923076923076923,0.0769230769230769,0,0.0769230769230769
"524",2020,"Oberrieden","D072",38,0,0,0,38,1,0,0,0
"525",2021,"Oberrieden","D072",42,5,0,5,47,0.893617021276596,0.106382978723404,0,0.106382978723404
"526",2022,"Oberrieden","D072",34,2,0,2,36,0.944444444444444,0.0555555555555556,0,0.0555555555555556
"528",2010,"Richterswil","D082",111,5,5,10,121,0.917355371900826,0.0413223140495868,0.0413223140495868,0.0826446280991736
"529",2011,"Richterswil","D082",109,0,5,5,114,0.956140350877193,0,0.043859649122807,0.043859649122807
"530",2012,"Richterswil","D082",124,3,6,9,133,0.932330827067669,0.0225563909774436,0.0451127819548872,0.0676691729323308
"531",2013,"Richterswil","D082",120,3,6,9,129,0.930232558139535,0.0232558139534884,0.0465116279069767,0.0697674418604651
"532",2014,"Richterswil","D082",153,2,7,9,162,0.944444444444444,0.0123456790123457,0.0432098765432099,0.0555555555555556
"533",2015,"Richterswil","D082",126,1,1,2,128,0.984375,0.0078125,0.0078125,0.015625
"534",2016,"Richterswil","D082",151,4,0,4,155,0.974193548387097,0.0258064516129032,0,0.0258064516129032
"535",2017,"Richterswil","D082",133,9,2,11,144,0.923611111111111,0.0625,0.0138888888888889,0.0763888888888889
"536",2018,"Richterswil","D082",153,6,1,7,160,0.95625,0.0375,0.00625,0.04375
"537",2019,"Richterswil","D082",149,9,0,9,158,0.943037974683544,0.0569620253164557,0,0.0569620253164557
"538",2020,"Richterswil","D082",135,17,0,17,152,0.888157894736842,0.111842105263158,0,0.111842105263158
"539",2021,"Richterswil","D082",121,14,0,14,135,0.896296296296296,0.103703703703704,0,0.103703703703704
"540",2022,"Richterswil","D082",142,9,0,9,151,0.940397350993378,0.0596026490066225,0,0.0596026490066225
"542",2010,"Rüschlikon","D092",36,3,1,4,40,0.9,0.075,0.025,0.1
"543",2011,"Rüschlikon","D092",28,0,5,5,33,0.848484848484849,0,0.151515151515152,0.151515151515152
"544",2012,"Rüschlikon","D092",40,0,2,2,42,0.952380952380952,0,0.0476190476190476,0.0476190476190476
"545",2013,"Rüschlikon","D092",40,0,1,1,41,0.975609756097561,0,0.024390243902439,0.024390243902439
"546",2014,"Rüschlikon","D092",53,0,1,1,54,0.981481481481482,0,0.0185185185185185,0.0185185185185185
"547",2015,"Rüschlikon","D092",47,4,3,7,54,0.87037037037037,0.0740740740740741,0.0555555555555556,0.12962962962963
"548",2016,"Rüschlikon","D092",42,3,4,7,49,0.857142857142857,0.0612244897959184,0.0816326530612245,0.142857142857143
"549",2017,"Rüschlikon","D092",53,2,1,3,56,0.946428571428571,0.0357142857142857,0.0178571428571429,0.0535714285714286
"550",2018,"Rüschlikon","D092",61,2,0,2,63,0.968253968253968,0.0317460317460317,0,0.0317460317460317
"551",2019,"Rüschlikon","D092",67,3,0,3,70,0.957142857142857,0.0428571428571429,0,0.0428571428571429
"552",2020,"Rüschlikon","D092",60,1,0,1,61,0.983606557377049,0.0163934426229508,0,0.0163934426229508
"553",2021,"Rüschlikon","D092",62,3,0,3,65,0.953846153846154,0.0461538461538462,0,0.0461538461538462
"554",2022,"Rüschlikon","D092",64,2,0,2,66,0.96969696969697,0.0303030303030303,0,0.0303030303030303
"556",2010,"Schönenberg","D100",21,0,0,0,21,1,0,0,0
"557",2011,"Schönenberg","D100",9,1,0,1,10,0.9,0.1,0,0.1
"558",2012,"Schönenberg","D100",19,0,1,1,20,0.95,0,0.05,0.05
"559",2013,"Schönenberg","D100",16,0,2,2,18,0.888888888888889,0,0.111111111111111,0.111111111111111
"560",2014,"Schönenberg","D100",9,0,1,1,10,0.9,0,0.1,0.1
"561",2015,"Schönenberg","D100",15,0,0,0,15,1,0,0,0
"562",2016,"Schönenberg","D100",14,1,0,1,15,0.933333333333333,0.0666666666666667,0,0.0666666666666667
"563",2017,"Schönenberg","D100",20,0,0,0,20,1,0,0,0
"564",2018,"Schönenberg","D100",17,1,0,1,18,0.944444444444444,0.0555555555555556,0,0.0555555555555556
"566",2010,"Thalwil","D112",112,3,11,14,126,0.888888888888889,0.0238095238095238,0.0873015873015873,0.111111111111111
"567",2011,"Thalwil","D112",131,1,4,5,136,0.963235294117647,0.00735294117647059,0.0294117647058824,0.0367647058823529
"568",2012,"Thalwil","D112",153,1,0,1,154,0.993506493506494,0.00649350649350649,0,0.00649350649350649
"569",2013,"Thalwil","D112",167,5,0,5,172,0.970930232558139,0.0290697674418605,0,0.0290697674418605
"570",2014,"Thalwil","D112",164,5,0,5,169,0.970414201183432,0.029585798816568,0,0.029585798816568
"571",2015,"Thalwil","D112",178,3,0,3,181,0.983425414364641,0.0165745856353591,0,0.0165745856353591
"572",2016,"Thalwil","D112",170,2,2,4,174,0.977011494252874,0.0114942528735632,0.0114942528735632,0.0229885057471264
"573",2017,"Thalwil","D112",150,5,2,7,157,0.955414012738854,0.0318471337579618,0.0127388535031847,0.0445859872611465
"574",2018,"Thalwil","D112",176,1,1,2,178,0.98876404494382,0.00561797752808989,0.00561797752808989,0.0112359550561798
"575",2019,"Thalwil","D112",177,9,0,9,186,0.951612903225806,0.0483870967741935,0,0.0483870967741935
"576",2020,"Thalwil","D112",177,11,0,11,188,0.941489361702128,0.0585106382978723,0,0.0585106382978723
"577",2021,"Thalwil","D112",153,12,0,12,165,0.927272727272727,0.0727272727272727,0,0.0727272727272727
"578",2022,"Thalwil","D112",147,6,0,6,153,0.96078431372549,0.0392156862745098,0,0.0392156862745098
"580",2010,"Wädenswil","D120",171,2,11,13,184,0.929347826086957,0.0108695652173913,0.0597826086956522,0.0706521739130435
"581",2011,"Wädenswil","D120",183,2,2,4,187,0.978609625668449,0.0106951871657754,0.0106951871657754,0.0213903743315508
"582",2012,"Wädenswil","D120",184,4,1,5,189,0.973544973544973,0.0211640211640212,0.00529100529100529,0.0264550264550265
"583",2013,"Wädenswil","D120",185,4,6,10,195,0.948717948717949,0.0205128205128205,0.0307692307692308,0.0512820512820513
"584",2014,"Wädenswil","D120",190,8,2,10,200,0.95,0.04,0.01,0.05
"585",2015,"Wädenswil","D120",187,4,3,7,194,0.963917525773196,0.0206185567010309,0.0154639175257732,0.0360824742268041
"586",2016,"Wädenswil","D120",217,8,1,9,226,0.960176991150443,0.0353982300884956,0.00442477876106195,0.0398230088495575
"587",2017,"Wädenswil","D120",178,6,4,10,188,0.946808510638298,0.0319148936170213,0.0212765957446809,0.0531914893617021
"588",2018,"Wädenswil","D120",211,13,1,14,225,0.937777777777778,0.0577777777777778,0.00444444444444444,0.0622222222222222
"589",2019,"Wädenswil","D123",223,17,0,17,240,0.929166666666667,0.0708333333333333,0,0.0708333333333333
"590",2020,"Wädenswil","D123",221,15,1,16,237,0.932489451476793,0.0632911392405063,0.00421940928270042,0.0675105485232067
"591",2021,"Wädenswil","D123",211,11,0,11,222,0.95045045045045,0.0495495495495495,0,0.0495495495495495
"592",2022,"Wädenswil","D123",217,24,1,25,242,0.896694214876033,0.0991735537190083,0.00413223140495868,0.103305785123967
"594",2010,"Erlenbach","E010",50,2,4,6,56,0.892857142857143,0.0357142857142857,0.0714285714285714,0.107142857142857
"595",2011,"Erlenbach","E010",44,0,5,5,49,0.897959183673469,0,0.102040816326531,0.102040816326531
"596",2012,"Erlenbach","E010",42,0,6,6,48,0.875,0,0.125,0.125
"597",2013,"Erlenbach","E010",33,2,7,9,42,0.785714285714286,0.0476190476190476,0.166666666666667,0.214285714285714
"598",2014,"Erlenbach","E010",52,0,5,5,57,0.912280701754386,0,0.087719298245614,0.087719298245614
"599",2015,"Erlenbach","E010",42,1,6,7,49,0.857142857142857,0.0204081632653061,0.122448979591837,0.142857142857143
"600",2016,"Erlenbach","E010",42,0,4,4,46,0.91304347826087,0,0.0869565217391304,0.0869565217391304
"601",2017,"Erlenbach","E010",47,0,5,5,52,0.903846153846154,0,0.0961538461538462,0.0961538461538462
"602",2018,"Erlenbach","E010",44,1,0,1,45,0.977777777777778,0.0222222222222222,0,0.0222222222222222
"603",2019,"Erlenbach","E010",57,5,0,5,62,0.919354838709677,0.0806451612903226,0,0.0806451612903226
"604",2020,"Erlenbach","E010",52,3,0,3,55,0.945454545454545,0.0545454545454545,0,0.0545454545454545
"605",2021,"Erlenbach","E010",49,3,0,3,52,0.942307692307692,0.0576923076923077,0,0.0576923076923077
"606",2022,"Erlenbach","E010",44,3,0,3,47,0.936170212765957,0.0638297872340425,0,0.0638297872340425
"608",2010,"Herrliberg","E020",45,0,3,3,48,0.9375,0,0.0625,0.0625
"609",2011,"Herrliberg","E020",42,1,0,1,43,0.976744186046512,0.0232558139534884,0,0.0232558139534884
"610",2012,"Herrliberg","E020",43,0,1,1,44,0.977272727272727,0,0.0227272727272727,0.0227272727272727
"611",2013,"Herrliberg","E020",51,2,0,2,53,0.962264150943396,0.0377358490566038,0,0.0377358490566038
"612",2014,"Herrliberg","E020",64,0,0,0,64,1,0,0,0
"613",2015,"Herrliberg","E020",54,2,1,3,57,0.947368421052632,0.0350877192982456,0.0175438596491228,0.0526315789473684
"614",2016,"Herrliberg","E020",53,2,0,2,55,0.963636363636364,0.0363636363636364,0,0.0363636363636364
"615",2017,"Herrliberg","E020",61,3,0,3,64,0.953125,0.046875,0,0.046875
"616",2018,"Herrliberg","E020",65,1,0,1,66,0.984848484848485,0.0151515151515152,0,0.0151515151515152
"617",2019,"Herrliberg","E020",43,4,0,4,47,0.914893617021277,0.0851063829787234,0,0.0851063829787234
"618",2020,"Herrliberg","E020",54,3,0,3,57,0.947368421052632,0.0526315789473684,0,0.0526315789473684
"619",2021,"Herrliberg","E020",52,4,0,4,56,0.928571428571429,0.0714285714285714,0,0.0714285714285714
"620",2022,"Herrliberg","E020",63,3,0,3,66,0.954545454545455,0.0454545454545455,0,0.0454545454545455
"622",2010,"Hombrechtikon","E032",64,0,5,5,69,0.927536231884058,0,0.072463768115942,0.072463768115942
"623",2011,"Hombrechtikon","E032",84,2,0,2,86,0.976744186046512,0.0232558139534884,0,0.0232558139534884
"624",2012,"Hombrechtikon","E032",83,2,0,2,85,0.976470588235294,0.0235294117647059,0,0.0235294117647059
"625",2013,"Hombrechtikon","E032",78,3,0,3,81,0.962962962962963,0.037037037037037,0,0.037037037037037
"626",2014,"Hombrechtikon","E032",85,4,2,6,91,0.934065934065934,0.043956043956044,0.021978021978022,0.0659340659340659
"627",2015,"Hombrechtikon","E032",85,2,1,3,88,0.965909090909091,0.0227272727272727,0.0113636363636364,0.0340909090909091
"628",2016,"Hombrechtikon","E032",104,1,0,1,105,0.990476190476191,0.00952380952380952,0,0.00952380952380952
"629",2017,"Hombrechtikon","E032",70,5,1,6,76,0.921052631578947,0.0657894736842105,0.0131578947368421,0.0789473684210526
"630",2018,"Hombrechtikon","E032",81,8,1,9,90,0.9,0.0888888888888889,0.0111111111111111,0.1
"631",2019,"Hombrechtikon","E032",94,11,0,11,105,0.895238095238095,0.104761904761905,0,0.104761904761905
"632",2020,"Hombrechtikon","E032",88,5,0,5,93,0.946236559139785,0.0537634408602151,0,0.0537634408602151
"633",2021,"Hombrechtikon","E032",76,16,0,16,92,0.826086956521739,0.173913043478261,0,0.173913043478261
"634",2022,"Hombrechtikon","E032",82,12,0,12,94,0.872340425531915,0.127659574468085,0,0.127659574468085
"636",2010,"Küsnacht","E042",102,1,7,8,110,0.927272727272727,0.00909090909090909,0.0636363636363636,0.0727272727272727
"637",2011,"Küsnacht","E042",83,3,2,5,88,0.943181818181818,0.0340909090909091,0.0227272727272727,0.0568181818181818
"638",2012,"Küsnacht","E042",102,4,2,6,108,0.944444444444444,0.037037037037037,0.0185185185185185,0.0555555555555556
"639",2013,"Küsnacht","E042",119,0,6,6,125,0.952,0,0.048,0.048
"640",2014,"Küsnacht","E042",113,2,2,4,117,0.965811965811966,0.0170940170940171,0.0170940170940171,0.0341880341880342
"641",2015,"Küsnacht","E042",112,2,3,5,117,0.957264957264957,0.0170940170940171,0.0256410256410256,0.0427350427350427
"642",2016,"Küsnacht","E042",127,6,1,7,134,0.947761194029851,0.0447761194029851,0.00746268656716418,0.0522388059701493
"643",2017,"Küsnacht","E042",107,3,0,3,110,0.972727272727273,0.0272727272727273,0,0.0272727272727273
"644",2018,"Küsnacht","E042",104,4,0,4,108,0.962962962962963,0.037037037037037,0,0.037037037037037
"645",2019,"Küsnacht","E042",121,6,0,6,127,0.952755905511811,0.047244094488189,0,0.047244094488189
"646",2020,"Küsnacht","E042",113,4,0,4,117,0.965811965811966,0.0341880341880342,0,0.0341880341880342
"647",2021,"Küsnacht","E042",97,12,0,12,109,0.889908256880734,0.110091743119266,0,0.110091743119266
"648",2022,"Küsnacht","E042",110,7,0,7,117,0.94017094017094,0.0598290598290598,0,0.0598290598290598
"650",2010,"Männedorf","E052",105,1,3,4,109,0.963302752293578,0.00917431192660551,0.0275229357798165,0.036697247706422
"651",2011,"Männedorf","E052",111,1,3,4,115,0.965217391304348,0.00869565217391304,0.0260869565217391,0.0347826086956522
"652",2012,"Männedorf","E052",121,0,1,1,122,0.991803278688525,0,0.00819672131147541,0.00819672131147541
"653",2013,"Männedorf","E052",100,5,2,7,107,0.934579439252336,0.0467289719626168,0.0186915887850467,0.0654205607476635
"654",2014,"Männedorf","E052",100,1,3,4,104,0.961538461538462,0.00961538461538462,0.0288461538461538,0.0384615384615385
"655",2015,"Männedorf","E052",105,5,0,5,110,0.954545454545455,0.0454545454545455,0,0.0454545454545455
"656",2016,"Männedorf","E052",95,7,1,8,103,0.922330097087379,0.0679611650485437,0.00970873786407767,0.0776699029126214
"657",2017,"Männedorf","E052",87,7,0,7,94,0.925531914893617,0.074468085106383,0,0.074468085106383
"658",2018,"Männedorf","E052",116,6,0,6,122,0.950819672131147,0.0491803278688525,0,0.0491803278688525
"659",2019,"Männedorf","E052",99,8,0,8,107,0.925233644859813,0.0747663551401869,0,0.0747663551401869
"660",2020,"Männedorf","E052",86,10,0,10,96,0.895833333333333,0.104166666666667,0,0.104166666666667
"661",2021,"Männedorf","E052",111,8,0,8,119,0.932773109243697,0.0672268907563025,0,0.0672268907563025
"662",2022,"Männedorf","E052",93,6,0,6,99,0.939393939393939,0.0606060606060606,0,0.0606060606060606
"664",2010,"Meilen","E062",108,1,2,3,111,0.972972972972973,0.00900900900900901,0.018018018018018,0.027027027027027
"665",2011,"Meilen","E062",117,0,2,2,119,0.983193277310924,0,0.0168067226890756,0.0168067226890756
"666",2012,"Meilen","E062",112,0,2,2,114,0.982456140350877,0,0.0175438596491228,0.0175438596491228
"667",2013,"Meilen","E062",113,1,1,2,115,0.982608695652174,0.00869565217391304,0.00869565217391304,0.0173913043478261
"668",2014,"Meilen","E062",135,1,6,7,142,0.950704225352113,0.00704225352112676,0.0422535211267606,0.0492957746478873
"669",2015,"Meilen","E062",154,3,3,6,160,0.9625,0.01875,0.01875,0.0375
"670",2016,"Meilen","E062",133,5,3,8,141,0.943262411347518,0.0354609929078014,0.0212765957446809,0.0567375886524823
"671",2017,"Meilen","E062",145,2,2,4,149,0.973154362416107,0.0134228187919463,0.0134228187919463,0.0268456375838926
"672",2018,"Meilen","E062",125,4,0,4,129,0.968992248062015,0.0310077519379845,0,0.0310077519379845
"673",2019,"Meilen","E062",143,5,0,5,148,0.966216216216216,0.0337837837837838,0,0.0337837837837838
"674",2020,"Meilen","E062",155,11,0,11,166,0.933734939759036,0.0662650602409639,0,0.0662650602409639
"675",2021,"Meilen","E062",146,8,0,8,154,0.948051948051948,0.051948051948052,0,0.051948051948052
"676",2022,"Meilen","E062",128,9,0,9,137,0.934306569343066,0.0656934306569343,0,0.0656934306569343
"678",2010,"Oetwil am See","E072",42,1,2,3,45,0.933333333333333,0.0222222222222222,0.0444444444444444,0.0666666666666667
"679",2011,"Oetwil am See","E072",47,4,0,4,51,0.92156862745098,0.0784313725490196,0,0.0784313725490196
"680",2012,"Oetwil am See","E072",47,1,1,2,49,0.959183673469388,0.0204081632653061,0.0204081632653061,0.0408163265306122
"681",2013,"Oetwil am See","E072",49,1,0,1,50,0.98,0.02,0,0.02
"682",2014,"Oetwil am See","E072",40,1,1,2,42,0.952380952380952,0.0238095238095238,0.0238095238095238,0.0476190476190476
"683",2015,"Oetwil am See","E072",59,4,1,5,64,0.921875,0.0625,0.015625,0.078125
"684",2016,"Oetwil am See","E072",52,1,0,1,53,0.981132075471698,0.0188679245283019,0,0.0188679245283019
"685",2017,"Oetwil am See","E072",52,2,0,2,54,0.962962962962963,0.037037037037037,0,0.037037037037037
"686",2018,"Oetwil am See","E072",32,5,0,5,37,0.864864864864865,0.135135135135135,0,0.135135135135135
"687",2019,"Oetwil am See","E072",54,4,0,4,58,0.931034482758621,0.0689655172413793,0,0.0689655172413793
"688",2020,"Oetwil am See","E072",46,3,0,3,49,0.938775510204082,0.0612244897959184,0,0.0612244897959184
"689",2021,"Oetwil am See","E072",40,6,0,6,46,0.869565217391304,0.130434782608696,0,0.130434782608696
"690",2022,"Oetwil am See","E072",39,4,0,4,43,0.906976744186046,0.0930232558139535,0,0.0930232558139535
"692",2010,"Stäfa","E082",129,4,4,8,137,0.941605839416058,0.0291970802919708,0.0291970802919708,0.0583941605839416
"693",2011,"Stäfa","E082",118,5,2,7,125,0.944,0.04,0.016,0.056
"694",2012,"Stäfa","E082",135,2,0,2,137,0.985401459854015,0.0145985401459854,0,0.0145985401459854
"695",2013,"Stäfa","E082",117,4,1,5,122,0.959016393442623,0.0327868852459016,0.00819672131147541,0.040983606557377
"696",2014,"Stäfa","E082",111,1,1,2,113,0.982300884955752,0.00884955752212389,0.00884955752212389,0.0176991150442478
"697",2015,"Stäfa","E082",129,5,0,5,134,0.962686567164179,0.0373134328358209,0,0.0373134328358209
"698",2016,"Stäfa","E082",117,8,1,9,126,0.928571428571429,0.0634920634920635,0.00793650793650794,0.0714285714285714
"699",2017,"Stäfa","E082",103,5,1,6,109,0.944954128440367,0.0458715596330275,0.00917431192660551,0.055045871559633
"700",2018,"Stäfa","E082",106,8,0,8,114,0.929824561403509,0.0701754385964912,0,0.0701754385964912
"701",2019,"Stäfa","E082",91,12,0,12,103,0.883495145631068,0.116504854368932,0,0.116504854368932
"702",2020,"Stäfa","E082",111,18,0,18,129,0.86046511627907,0.13953488372093,0,0.13953488372093
"703",2021,"Stäfa","E082",104,9,0,9,113,0.920353982300885,0.079646017699115,0,0.079646017699115
"704",2022,"Stäfa","E082",125,11,0,11,136,0.919117647058823,0.0808823529411765,0,0.0808823529411765
"706",2010,"Uetikon am See","E092",35,0,4,4,39,0.897435897435897,0,0.102564102564103,0.102564102564103
"707",2011,"Uetikon am See","E092",51,0,0,0,51,1,0,0,0
"708",2012,"Uetikon am See","E092",44,1,2,3,47,0.936170212765957,0.0212765957446809,0.0425531914893617,0.0638297872340425
"709",2013,"Uetikon am See","E092",46,2,0,2,48,0.958333333333333,0.0416666666666667,0,0.0416666666666667
"710",2014,"Uetikon am See","E092",51,0,0,0,51,1,0,0,0
"711",2015,"Uetikon am See","E092",56,4,0,4,60,0.933333333333333,0.0666666666666667,0,0.0666666666666667
"712",2016,"Uetikon am See","E092",58,1,1,2,60,0.966666666666667,0.0166666666666667,0.0166666666666667,0.0333333333333333
"713",2017,"Uetikon am See","E092",43,6,0,6,49,0.877551020408163,0.122448979591837,0,0.122448979591837
"714",2018,"Uetikon am See","E092",40,5,0,5,45,0.888888888888889,0.111111111111111,0,0.111111111111111
"715",2019,"Uetikon am See","E092",62,4,0,4,66,0.939393939393939,0.0606060606060606,0,0.0606060606060606
"716",2020,"Uetikon am See","E092",60,4,0,4,64,0.9375,0.0625,0,0.0625
"717",2021,"Uetikon am See","E092",56,5,0,5,61,0.918032786885246,0.0819672131147541,0,0.0819672131147541
"718",2022,"Uetikon am See","E092",51,3,0,3,54,0.944444444444444,0.0555555555555556,0,0.0555555555555556
"720",2010,"Zollikon","E102",89,0,3,3,92,0.967391304347826,0,0.0326086956521739,0.0326086956521739
"721",2011,"Zollikon","E102",78,0,7,7,85,0.917647058823529,0,0.0823529411764706,0.0823529411764706
"722",2012,"Zollikon","E102",91,1,8,9,100,0.91,0.01,0.08,0.09
"723",2013,"Zollikon","E102",89,1,4,5,94,0.946808510638298,0.0106382978723404,0.0425531914893617,0.0531914893617021
"724",2014,"Zollikon","E102",104,3,3,6,110,0.945454545454545,0.0272727272727273,0.0272727272727273,0.0545454545454545
"725",2015,"Zollikon","E102",105,2,4,6,111,0.945945945945946,0.018018018018018,0.036036036036036,0.0540540540540541
"726",2016,"Zollikon","E102",109,3,2,5,114,0.956140350877193,0.0263157894736842,0.0175438596491228,0.043859649122807
"727",2017,"Zollikon","E102",86,3,4,7,93,0.924731182795699,0.032258064516129,0.043010752688172,0.0752688172043011
"728",2018,"Zollikon","E102",116,2,1,3,119,0.974789915966387,0.0168067226890756,0.00840336134453781,0.0252100840336134
"729",2019,"Zollikon","E102",122,3,0,3,125,0.976,0.024,0,0.024
"730",2020,"Zollikon","E102",97,8,1,9,106,0.915094339622642,0.0754716981132075,0.00943396226415094,0.0849056603773585
"731",2021,"Zollikon","E102",108,8,0,8,116,0.931034482758621,0.0689655172413793,0,0.0689655172413793
"732",2022,"Zollikon","E102",123,5,0,5,128,0.9609375,0.0390625,0,0.0390625
"734",2010,"Zumikon","E112",44,0,1,1,45,0.977777777777778,0,0.0222222222222222,0.0222222222222222
"735",2011,"Zumikon","E112",45,0,2,2,47,0.957446808510638,0,0.0425531914893617,0.0425531914893617
"736",2012,"Zumikon","E112",46,0,1,1,47,0.978723404255319,0,0.0212765957446809,0.0212765957446809
"737",2013,"Zumikon","E112",51,0,1,1,52,0.980769230769231,0,0.0192307692307692,0.0192307692307692
"738",2014,"Zumikon","E112",35,0,0,0,35,1,0,0,0
"739",2015,"Zumikon","E112",47,1,2,3,50,0.94,0.02,0.04,0.06
"740",2016,"Zumikon","E112",41,2,0,2,43,0.953488372093023,0.0465116279069767,0,0.0465116279069767
"741",2017,"Zumikon","E112",40,1,0,1,41,0.975609756097561,0.024390243902439,0,0.024390243902439
"742",2018,"Zumikon","E112",40,2,1,3,43,0.930232558139535,0.0465116279069767,0.0232558139534884,0.0697674418604651
"743",2019,"Zumikon","E112",51,3,0,3,54,0.944444444444444,0.0555555555555556,0,0.0555555555555556
"744",2020,"Zumikon","E112",36,4,0,4,40,0.9,0.1,0,0.1
"745",2021,"Zumikon","E112",42,2,0,2,44,0.954545454545455,0.0454545454545455,0,0.0454545454545455
"746",2022,"Zumikon","E112",51,4,0,4,55,0.927272727272727,0.0727272727272727,0,0.0727272727272727
"748",2010,"Bäretswil","F012",43,2,2,4,47,0.914893617021277,0.0425531914893617,0.0425531914893617,0.0851063829787234
"749",2011,"Bäretswil","F012",43,1,2,3,46,0.934782608695652,0.0217391304347826,0.0434782608695652,0.0652173913043478
"750",2012,"Bäretswil","F012",50,3,3,6,56,0.892857142857143,0.0535714285714286,0.0535714285714286,0.107142857142857
"751",2013,"Bäretswil","F012",41,1,0,1,42,0.976190476190476,0.0238095238095238,0,0.0238095238095238
"752",2014,"Bäretswil","F012",47,4,0,4,51,0.92156862745098,0.0784313725490196,0,0.0784313725490196
"753",2015,"Bäretswil","F012",49,1,0,1,50,0.98,0.02,0,0.02
"754",2016,"Bäretswil","F012",34,4,1,5,39,0.871794871794872,0.102564102564103,0.0256410256410256,0.128205128205128
"755",2017,"Bäretswil","F012",53,9,0,9,62,0.854838709677419,0.145161290322581,0,0.145161290322581
"756",2018,"Bäretswil","F012",50,10,1,11,61,0.819672131147541,0.163934426229508,0.0163934426229508,0.180327868852459
"757",2019,"Bäretswil","F012",46,4,0,4,50,0.92,0.08,0,0.08
"758",2020,"Bäretswil","F012",38,10,0,10,48,0.791666666666667,0.208333333333333,0,0.208333333333333
"759",2021,"Bäretswil","F012",42,9,0,9,51,0.823529411764706,0.176470588235294,0,0.176470588235294
"760",2022,"Bäretswil","F012",60,14,0,14,74,0.810810810810811,0.189189189189189,0,0.189189189189189
"762",2010,"Bubikon","F032",75,0,3,3,78,0.961538461538462,0,0.0384615384615385,0.0384615384615385
"763",2011,"Bubikon","F032",78,1,0,1,79,0.987341772151899,0.0126582278481013,0,0.0126582278481013
"764",2012,"Bubikon","F032",75,0,1,1,76,0.986842105263158,0,0.0131578947368421,0.0131578947368421
"765",2013,"Bubikon","F032",71,4,0,4,75,0.946666666666667,0.0533333333333333,0,0.0533333333333333
"766",2014,"Bubikon","F032",71,3,2,5,76,0.934210526315789,0.0394736842105263,0.0263157894736842,0.0657894736842105
"767",2015,"Bubikon","F032",80,3,2,5,85,0.941176470588235,0.0352941176470588,0.0235294117647059,0.0588235294117647
"768",2016,"Bubikon","F032",76,4,0,4,80,0.95,0.05,0,0.05
"769",2017,"Bubikon","F032",70,5,0,5,75,0.933333333333333,0.0666666666666667,0,0.0666666666666667
"770",2018,"Bubikon","F032",82,9,0,9,91,0.901098901098901,0.0989010989010989,0,0.0989010989010989
"771",2019,"Bubikon","F032",66,11,0,11,77,0.857142857142857,0.142857142857143,0,0.142857142857143
"772",2020,"Bubikon","F032",71,13,0,13,84,0.845238095238095,0.154761904761905,0,0.154761904761905
"773",2021,"Bubikon","F032",68,5,0,5,73,0.931506849315068,0.0684931506849315,0,0.0684931506849315
"774",2022,"Bubikon","F032",66,11,0,11,77,0.857142857142857,0.142857142857143,0,0.142857142857143
"776",2010,"Dürnten","F042",72,2,1,3,75,0.96,0.0266666666666667,0.0133333333333333,0.04
"777",2011,"Dürnten","F042",71,2,2,4,75,0.946666666666667,0.0266666666666667,0.0266666666666667,0.0533333333333333
"778",2012,"Dürnten","F042",86,3,0,3,89,0.966292134831461,0.0337078651685393,0,0.0337078651685393
"779",2013,"Dürnten","F042",74,3,0,3,77,0.961038961038961,0.038961038961039,0,0.038961038961039
"780",2014,"Dürnten","F042",69,3,2,5,74,0.932432432432432,0.0405405405405405,0.027027027027027,0.0675675675675676
"781",2015,"Dürnten","F042",75,4,0,4,79,0.949367088607595,0.0506329113924051,0,0.0506329113924051
"782",2016,"Dürnten","F042",71,1,1,2,73,0.972602739726027,0.0136986301369863,0.0136986301369863,0.0273972602739726
"783",2017,"Dürnten","F042",88,3,0,3,91,0.967032967032967,0.032967032967033,0,0.032967032967033
"784",2018,"Dürnten","F042",78,6,0,6,84,0.928571428571429,0.0714285714285714,0,0.0714285714285714
"785",2019,"Dürnten","F042",64,4,0,4,68,0.941176470588235,0.0588235294117647,0,0.0588235294117647
"786",2020,"Dürnten","F042",65,10,0,10,75,0.866666666666667,0.133333333333333,0,0.133333333333333
"787",2021,"Dürnten","F042",71,16,0,16,87,0.816091954022989,0.183908045977011,0,0.183908045977011
"788",2022,"Dürnten","F042",65,9,0,9,74,0.878378378378378,0.121621621621622,0,0.121621621621622
"790",2010,"Fischenthal","F062",31,0,0,0,31,1,0,0,0
"791",2011,"Fischenthal","F062",22,0,0,0,22,1,0,0,0
"792",2012,"Fischenthal","F062",36,0,1,1,37,0.972972972972973,0,0.027027027027027,0.027027027027027
"793",2013,"Fischenthal","F062",26,1,0,1,27,0.962962962962963,0.037037037037037,0,0.037037037037037
"794",2014,"Fischenthal","F062",23,1,1,2,25,0.92,0.04,0.04,0.08
"795",2015,"Fischenthal","F062",28,2,0,2,30,0.933333333333333,0.0666666666666667,0,0.0666666666666667
"796",2016,"Fischenthal","F062",38,3,0,3,41,0.926829268292683,0.0731707317073171,0,0.0731707317073171
"797",2017,"Fischenthal","F062",30,3,0,3,33,0.909090909090909,0.0909090909090909,0,0.0909090909090909
"798",2018,"Fischenthal","F062",18,1,0,1,19,0.947368421052632,0.0526315789473684,0,0.0526315789473684
"799",2019,"Fischenthal","F062",26,3,0,3,29,0.896551724137931,0.103448275862069,0,0.103448275862069
"800",2020,"Fischenthal","F062",22,4,0,4,26,0.846153846153846,0.153846153846154,0,0.153846153846154
"801",2021,"Fischenthal","F062",23,4,0,4,27,0.851851851851852,0.148148148148148,0,0.148148148148148
"802",2022,"Fischenthal","F062",28,3,0,3,31,0.903225806451613,0.0967741935483871,0,0.0967741935483871
"804",2010,"Gossau","F070",84,1,1,2,86,0.976744186046512,0.0116279069767442,0.0116279069767442,0.0232558139534884
"805",2011,"Gossau","F072",87,1,2,3,90,0.966666666666667,0.0111111111111111,0.0222222222222222,0.0333333333333333
"806",2012,"Gossau","F072",92,6,0,6,98,0.938775510204082,0.0612244897959184,0,0.0612244897959184
"807",2013,"Gossau","F072",121,3,1,4,125,0.968,0.024,0.008,0.032
"808",2014,"Gossau","F072",83,5,1,6,89,0.932584269662921,0.0561797752808989,0.0112359550561798,0.0674157303370786
"809",2015,"Gossau","F072",101,4,0,4,105,0.961904761904762,0.0380952380952381,0,0.0380952380952381
"810",2016,"Gossau","F072",92,4,1,5,97,0.948453608247423,0.0412371134020619,0.0103092783505155,0.0515463917525773
"811",2017,"Gossau","F072",92,7,2,9,101,0.910891089108911,0.0693069306930693,0.0198019801980198,0.0891089108910891
"812",2018,"Gossau","F072",97,9,0,9,106,0.915094339622642,0.0849056603773585,0,0.0849056603773585
"813",2019,"Gossau","F072",91,15,0,15,106,0.858490566037736,0.141509433962264,0,0.141509433962264
"814",2020,"Gossau","F072",81,20,0,20,101,0.801980198019802,0.198019801980198,0,0.198019801980198
"815",2021,"Gossau","F072",89,19,0,19,108,0.824074074074074,0.175925925925926,0,0.175925925925926
"816",2022,"Gossau","F072",91,10,0,10,101,0.900990099009901,0.099009900990099,0,0.099009900990099
"818",2010,"Grüningen","F092",28,0,1,1,29,0.96551724137931,0,0.0344827586206897,0.0344827586206897
"819",2011,"Grüningen","F092",31,0,0,0,31,1,0,0,0
"820",2012,"Grüningen","F092",32,1,0,1,33,0.96969696969697,0.0303030303030303,0,0.0303030303030303
"821",2013,"Grüningen","F092",34,2,1,3,37,0.918918918918919,0.0540540540540541,0.027027027027027,0.0810810810810811
"822",2014,"Grüningen","F092",40,0,2,2,42,0.952380952380952,0,0.0476190476190476,0.0476190476190476
"823",2015,"Grüningen","F092",31,2,0,2,33,0.939393939393939,0.0606060606060606,0,0.0606060606060606
"824",2016,"Grüningen","F092",30,2,2,4,34,0.882352941176471,0.0588235294117647,0.0588235294117647,0.117647058823529
"825",2017,"Grüningen","F092",35,5,0,5,40,0.875,0.125,0,0.125
"826",2018,"Grüningen","F092",29,7,0,7,36,0.805555555555556,0.194444444444444,0,0.194444444444444
"827",2019,"Grüningen","F092",38,7,0,7,45,0.844444444444444,0.155555555555556,0,0.155555555555556
"828",2020,"Grüningen","F092",41,12,0,12,53,0.773584905660377,0.226415094339623,0,0.226415094339623
"829",2021,"Grüningen","F092",45,4,0,4,49,0.918367346938776,0.0816326530612245,0,0.0816326530612245
"830",2022,"Grüningen","F092",37,7,0,7,44,0.840909090909091,0.159090909090909,0,0.159090909090909
"832",2010,"Hinwil","F102",88,3,1,4,92,0.956521739130435,0.0326086956521739,0.0108695652173913,0.0434782608695652
"833",2011,"Hinwil","F102",83,1,4,5,88,0.943181818181818,0.0113636363636364,0.0454545454545455,0.0568181818181818
"834",2012,"Hinwil","F102",85,1,7,8,93,0.913978494623656,0.010752688172043,0.0752688172043011,0.0860215053763441
"835",2013,"Hinwil","F102",88,6,1,7,95,0.926315789473684,0.0631578947368421,0.0105263157894737,0.0736842105263158
"836",2014,"Hinwil","F102",129,8,0,8,137,0.941605839416058,0.0583941605839416,0,0.0583941605839416
"837",2015,"Hinwil","F102",117,3,2,5,122,0.959016393442623,0.0245901639344262,0.0163934426229508,0.040983606557377
"838",2016,"Hinwil","F102",103,6,1,7,110,0.936363636363636,0.0545454545454545,0.00909090909090909,0.0636363636363636
"839",2017,"Hinwil","F102",96,5,0,5,101,0.95049504950495,0.0495049504950495,0,0.0495049504950495
"840",2018,"Hinwil","F102",101,8,1,9,110,0.918181818181818,0.0727272727272727,0.00909090909090909,0.0818181818181818
"841",2019,"Hinwil","F102",99,13,0,13,112,0.883928571428571,0.116071428571429,0,0.116071428571429
"842",2020,"Hinwil","F102",99,10,0,10,109,0.908256880733945,0.0917431192660551,0,0.0917431192660551
"843",2021,"Hinwil","F102",90,17,0,17,107,0.841121495327103,0.158878504672897,0,0.158878504672897
"844",2022,"Hinwil","F102",91,7,1,8,99,0.919191919191919,0.0707070707070707,0.0101010101010101,0.0808080808080808
"846",2010,"Rüti","F120",123,3,3,6,129,0.953488372093023,0.0232558139534884,0.0232558139534884,0.0465116279069767
"847",2011,"Rüti","F120",106,4,1,5,111,0.954954954954955,0.036036036036036,0.00900900900900901,0.045045045045045
"848",2012,"Rüti","F120",102,3,6,9,111,0.918918918918919,0.027027027027027,0.0540540540540541,0.0810810810810811
"849",2013,"Rüti","F120",110,2,3,5,115,0.956521739130435,0.0173913043478261,0.0260869565217391,0.0434782608695652
"850",2014,"Rüti","F122",102,1,4,5,107,0.953271028037383,0.00934579439252336,0.0373831775700935,0.0467289719626168
"851",2015,"Rüti","F122",112,2,1,3,115,0.973913043478261,0.0173913043478261,0.00869565217391304,0.0260869565217391
"852",2016,"Rüti","F122",107,3,0,3,110,0.972727272727273,0.0272727272727273,0,0.0272727272727273
"853",2017,"Rüti","F122",128,9,0,9,137,0.934306569343066,0.0656934306569343,0,0.0656934306569343
"854",2018,"Rüti","F122",105,10,0,10,115,0.91304347826087,0.0869565217391304,0,0.0869565217391304
"855",2019,"Rüti","F122",96,14,0,14,110,0.872727272727273,0.127272727272727,0,0.127272727272727
"856",2020,"Rüti","F122",115,14,0,14,129,0.891472868217054,0.108527131782946,0,0.108527131782946
"857",2021,"Rüti","F122",122,11,0,11,133,0.917293233082707,0.0827067669172932,0,0.0827067669172932
"858",2022,"Rüti","F122",116,13,0,13,129,0.89922480620155,0.10077519379845,0,0.10077519379845
"860",2010,"Seegräben","F140",12,0,2,2,14,0.857142857142857,0,0.142857142857143,0.142857142857143
"861",2011,"Seegräben","F140",11,1,0,1,12,0.916666666666667,0.0833333333333333,0,0.0833333333333333
"862",2012,"Seegräben","F140",11,0,1,1,12,0.916666666666667,0,0.0833333333333333,0.0833333333333333
"863",2013,"Seegräben","F140",13,0,2,2,15,0.866666666666667,0,0.133333333333333,0.133333333333333
"864",2014,"Seegräben","F140",10,0,1,1,11,0.909090909090909,0,0.0909090909090909,0.0909090909090909
"865",2015,"Seegräben","F140",15,0,0,0,15,1,0,0,0
"866",2016,"Seegräben","F140",14,0,1,1,15,0.933333333333333,0,0.0666666666666667,0.0666666666666667
"867",2017,"Seegräben","F140",20,2,0,2,22,0.909090909090909,0.0909090909090909,0,0.0909090909090909
"868",2018,"Seegräben","F140",13,2,0,2,15,0.866666666666667,0.133333333333333,0,0.133333333333333
"869",2019,"Seegräben","F140",14,1,0,1,15,0.933333333333333,0.0666666666666667,0,0.0666666666666667
"870",2020,"Seegräben","F140",14,0,0,0,14,1,0,0,0
"871",2021,"Seegräben","F140",11,1,0,1,12,0.916666666666667,0.0833333333333333,0,0.0833333333333333
"872",2022,"Seegräben","F140",10,4,0,4,14,0.714285714285714,0.285714285714286,0,0.285714285714286
"874",2010,"Wald","F152",88,0,3,3,91,0.967032967032967,0,0.032967032967033,0.032967032967033
"875",2011,"Wald","F152",85,0,0,0,85,1,0,0,0
"876",2012,"Wald","F152",94,1,1,2,96,0.979166666666667,0.0104166666666667,0.0104166666666667,0.0208333333333333
"877",2013,"Wald","F152",90,2,0,2,92,0.978260869565217,0.0217391304347826,0,0.0217391304347826
"878",2014,"Wald","F152",77,1,0,1,78,0.987179487179487,0.0128205128205128,0,0.0128205128205128
"879",2015,"Wald","F152",96,2,0,2,98,0.979591836734694,0.0204081632653061,0,0.0204081632653061
"880",2016,"Wald","F152",99,4,0,4,103,0.961165048543689,0.0388349514563107,0,0.0388349514563107
"881",2017,"Wald","F152",71,2,0,2,73,0.972602739726027,0.0273972602739726,0,0.0273972602739726
"882",2018,"Wald","F152",117,4,0,4,121,0.966942148760331,0.0330578512396694,0,0.0330578512396694
"883",2019,"Wald","F152",99,7,0,7,106,0.933962264150943,0.0660377358490566,0,0.0660377358490566
"884",2020,"Wald","F152",88,6,0,6,94,0.936170212765957,0.0638297872340425,0,0.0638297872340425
"885",2021,"Wald","F152",81,12,0,12,93,0.870967741935484,0.129032258064516,0,0.129032258064516
"886",2022,"Wald","F152",103,11,0,11,114,0.903508771929825,0.0964912280701754,0,0.0964912280701754
"888",2010,"Wetzikon","F170",207,2,14,16,223,0.928251121076233,0.00896860986547085,0.062780269058296,0.0717488789237668
"889",2011,"Wetzikon","F170",196,7,12,19,215,0.911627906976744,0.0325581395348837,0.0558139534883721,0.0883720930232558
"890",2012,"Wetzikon","F170",207,5,5,10,217,0.953917050691244,0.0230414746543779,0.0230414746543779,0.0460829493087558
"891",2013,"Wetzikon","F170",203,5,4,9,212,0.957547169811321,0.0235849056603774,0.0188679245283019,0.0424528301886792
"892",2014,"Wetzikon","F170",217,5,2,7,224,0.96875,0.0223214285714286,0.00892857142857143,0.03125
"893",2015,"Wetzikon","F170",223,4,3,7,230,0.969565217391304,0.0173913043478261,0.0130434782608696,0.0304347826086957
"894",2016,"Wetzikon","F170",231,5,2,7,238,0.970588235294118,0.0210084033613445,0.00840336134453781,0.0294117647058824
"895",2017,"Wetzikon","F170",228,10,2,12,240,0.95,0.0416666666666667,0.00833333333333333,0.05
"896",2018,"Wetzikon","F173",238,7,0,7,245,0.971428571428571,0.0285714285714286,0,0.0285714285714286
"897",2019,"Wetzikon","F173",253,20,0,20,273,0.926739926739927,0.0732600732600733,0,0.0732600732600733
"898",2020,"Wetzikon","F173",261,17,0,17,278,0.938848920863309,0.0611510791366906,0,0.0611510791366906
"899",2021,"Wetzikon","F173",247,25,0,25,272,0.908088235294118,0.0919117647058824,0,0.0919117647058824
"900",2022,"Wetzikon","F173",257,14,0,14,271,0.948339483394834,0.0516605166051661,0,0.0516605166051661
"902",2010,"Dübendorf","G010",211,0,9,9,220,0.959090909090909,0,0.0409090909090909,0.0409090909090909
"903",2011,"Dübendorf","G010",201,1,12,13,214,0.939252336448598,0.00467289719626168,0.0560747663551402,0.0607476635514019
"904",2012,"Dübendorf","G010",231,1,4,5,236,0.978813559322034,0.00423728813559322,0.0169491525423729,0.0211864406779661
"905",2013,"Dübendorf","G010",212,3,5,8,220,0.963636363636364,0.0136363636363636,0.0227272727272727,0.0363636363636364
"906",2014,"Dübendorf","G010",238,1,3,4,242,0.983471074380165,0.00413223140495868,0.012396694214876,0.0165289256198347
"907",2015,"Dübendorf","G010",234,2,1,3,237,0.987341772151899,0.00843881856540084,0.00421940928270042,0.0126582278481013
"908",2016,"Dübendorf","G010",245,7,4,11,256,0.95703125,0.02734375,0.015625,0.04296875
"909",2017,"Dübendorf","G010",223,5,2,7,230,0.969565217391304,0.0217391304347826,0.00869565217391304,0.0304347826086957
"910",2018,"Dübendorf","G010",238,6,2,8,246,0.967479674796748,0.024390243902439,0.00813008130081301,0.032520325203252
"911",2019,"Dübendorf","G010",241,7,0,7,248,0.971774193548387,0.0282258064516129,0,0.0282258064516129
"912",2020,"Dübendorf","G010",270,18,0,18,288,0.9375,0.0625,0,0.0625
"913",2021,"Dübendorf","G010",219,9,0,9,228,0.960526315789474,0.0394736842105263,0,0.0394736842105263
"914",2022,"Dübendorf","G010",238,11,0,11,249,0.955823293172691,0.0441767068273092,0,0.0441767068273092
"916",2010,"Egg","G032",70,2,1,3,73,0.958904109589041,0.0273972602739726,0.0136986301369863,0.0410958904109589
"917",2011,"Egg","G032",59,1,3,4,63,0.936507936507937,0.0158730158730159,0.0476190476190476,0.0634920634920635
"918",2012,"Egg","G032",62,1,3,4,66,0.939393939393939,0.0151515151515152,0.0454545454545455,0.0606060606060606
"919",2013,"Egg","G032",77,1,4,5,82,0.939024390243902,0.0121951219512195,0.0487804878048781,0.0609756097560976
"920",2014,"Egg","G032",93,3,2,5,98,0.948979591836735,0.0306122448979592,0.0204081632653061,0.0510204081632653
"921",2015,"Egg","G032",74,1,1,2,76,0.973684210526316,0.0131578947368421,0.0131578947368421,0.0263157894736842
"922",2016,"Egg","G032",82,3,0,3,85,0.964705882352941,0.0352941176470588,0,0.0352941176470588
"923",2017,"Egg","G032",81,6,1,7,88,0.920454545454545,0.0681818181818182,0.0113636363636364,0.0795454545454545
"924",2018,"Egg","G032",86,7,0,7,93,0.924731182795699,0.0752688172043011,0,0.0752688172043011
"925",2019,"Egg","G032",71,8,0,8,79,0.89873417721519,0.10126582278481,0,0.10126582278481
"926",2020,"Egg","G032",84,5,0,5,89,0.943820224719101,0.0561797752808989,0,0.0561797752808989
"927",2021,"Egg","G032",84,9,0,9,93,0.903225806451613,0.0967741935483871,0,0.0967741935483871
"928",2022,"Egg","G032",74,6,0,6,80,0.925,0.075,0,0.075
"930",2010,"Fällanden","G042",80,1,5,6,86,0.930232558139535,0.0116279069767442,0.0581395348837209,0.0697674418604651
"931",2011,"Fällanden","G042",71,1,3,4,75,0.946666666666667,0.0133333333333333,0.04,0.0533333333333333
"932",2012,"Fällanden","G042",88,1,2,3,91,0.967032967032967,0.010989010989011,0.021978021978022,0.032967032967033
"933",2013,"Fällanden","G042",84,1,7,8,92,0.91304347826087,0.0108695652173913,0.0760869565217391,0.0869565217391304
"934",2014,"Fällanden","G042",91,0,0,0,91,1,0,0,0
"935",2015,"Fällanden","G042",92,1,5,6,98,0.938775510204082,0.0102040816326531,0.0510204081632653,0.0612244897959184
"936",2016,"Fällanden","G042",100,3,1,4,104,0.961538461538462,0.0288461538461538,0.00961538461538462,0.0384615384615385
"937",2017,"Fällanden","G042",77,7,2,9,86,0.895348837209302,0.0813953488372093,0.0232558139534884,0.104651162790698
"938",2018,"Fällanden","G042",83,4,0,4,87,0.954022988505747,0.0459770114942529,0,0.0459770114942529
"939",2019,"Fällanden","G042",99,2,0,2,101,0.98019801980198,0.0198019801980198,0,0.0198019801980198
"940",2020,"Fällanden","G042",101,4,0,4,105,0.961904761904762,0.0380952380952381,0,0.0380952380952381
"941",2021,"Fällanden","G042",86,9,0,9,95,0.905263157894737,0.0947368421052632,0,0.0947368421052632
"942",2022,"Fällanden","G042",97,5,0,5,102,0.950980392156863,0.0490196078431373,0,0.0490196078431373
"944",2010,"Greifensee","G050",36,1,3,4,40,0.9,0.025,0.075,0.1
"945",2011,"Greifensee","G050",53,5,2,7,60,0.883333333333333,0.0833333333333333,0.0333333333333333,0.116666666666667
"946",2012,"Greifensee","G050",55,1,1,2,57,0.964912280701754,0.0175438596491228,0.0175438596491228,0.0350877192982456
"947",2013,"Greifensee","G050",63,0,2,2,65,0.969230769230769,0,0.0307692307692308,0.0307692307692308
"948",2014,"Greifensee","G050",61,0,1,1,62,0.983870967741935,0,0.0161290322580645,0.0161290322580645
"949",2015,"Greifensee","G050",59,2,3,5,64,0.921875,0.03125,0.046875,0.078125
"950",2016,"Greifensee","G050",47,3,2,5,52,0.903846153846154,0.0576923076923077,0.0384615384615385,0.0961538461538462
"951",2017,"Greifensee","G050",60,6,0,6,66,0.909090909090909,0.0909090909090909,0,0.0909090909090909
"952",2018,"Greifensee","G050",53,5,0,5,58,0.913793103448276,0.0862068965517241,0,0.0862068965517241
"953",2019,"Greifensee","G050",75,5,0,5,80,0.9375,0.0625,0,0.0625
"954",2020,"Greifensee","G050",56,7,0,7,63,0.888888888888889,0.111111111111111,0,0.111111111111111
"955",2021,"Greifensee","G050",54,3,0,3,57,0.947368421052632,0.0526315789473684,0,0.0526315789473684
"956",2022,"Greifensee","G050",44,3,0,3,47,0.936170212765957,0.0638297872340425,0,0.0638297872340425
"958",2010,"Maur","G062",84,1,1,2,86,0.976744186046512,0.0116279069767442,0.0116279069767442,0.0232558139534884
"959",2011,"Maur","G062",72,3,3,6,78,0.923076923076923,0.0384615384615385,0.0384615384615385,0.0769230769230769
"960",2012,"Maur","G062",98,2,3,5,103,0.951456310679612,0.0194174757281553,0.029126213592233,0.0485436893203883
"961",2013,"Maur","G062",86,1,1,2,88,0.977272727272727,0.0113636363636364,0.0113636363636364,0.0227272727272727
"962",2014,"Maur","G062",90,1,4,5,95,0.947368421052632,0.0105263157894737,0.0421052631578947,0.0526315789473684
"963",2015,"Maur","G062",74,1,2,3,77,0.961038961038961,0.012987012987013,0.025974025974026,0.038961038961039
"964",2016,"Maur","G062",96,0,0,0,96,1,0,0,0
"965",2017,"Maur","G062",103,3,1,4,107,0.962616822429907,0.0280373831775701,0.00934579439252336,0.0373831775700935
"966",2018,"Maur","G062",104,4,0,4,108,0.962962962962963,0.037037037037037,0,0.037037037037037
"967",2019,"Maur","G062",104,2,0,2,106,0.981132075471698,0.0188679245283019,0,0.0188679245283019
"968",2020,"Maur","G062",102,5,0,5,107,0.953271028037383,0.0467289719626168,0,0.0467289719626168
"969",2021,"Maur","G062",85,8,0,8,93,0.913978494623656,0.0860215053763441,0,0.0860215053763441
"970",2022,"Maur","G062",98,9,0,9,107,0.91588785046729,0.0841121495327103,0,0.0841121495327103
"972",2010,"Mönchaltorf","G072",28,0,1,1,29,0.96551724137931,0,0.0344827586206897,0.0344827586206897
"973",2011,"Mönchaltorf","G072",28,0,1,1,29,0.96551724137931,0,0.0344827586206897,0.0344827586206897
"974",2012,"Mönchaltorf","G072",25,0,1,1,26,0.961538461538462,0,0.0384615384615385,0.0384615384615385
"975",2013,"Mönchaltorf","G072",34,0,0,0,34,1,0,0,0
"976",2014,"Mönchaltorf","G072",32,1,0,1,33,0.96969696969697,0.0303030303030303,0,0.0303030303030303
"977",2015,"Mönchaltorf","G072",37,1,4,5,42,0.880952380952381,0.0238095238095238,0.0952380952380952,0.119047619047619
"978",2016,"Mönchaltorf","G072",41,2,0,2,43,0.953488372093023,0.0465116279069767,0,0.0465116279069767
"979",2017,"Mönchaltorf","G072",44,4,1,5,49,0.897959183673469,0.0816326530612245,0.0204081632653061,0.102040816326531
"980",2018,"Mönchaltorf","G072",39,3,0,3,42,0.928571428571429,0.0714285714285714,0,0.0714285714285714
"981",2019,"Mönchaltorf","G072",45,3,0,3,48,0.9375,0.0625,0,0.0625
"982",2020,"Mönchaltorf","G072",38,4,0,4,42,0.904761904761905,0.0952380952380952,0,0.0952380952380952
"983",2021,"Mönchaltorf","G072",38,5,0,5,43,0.883720930232558,0.116279069767442,0,0.116279069767442
"984",2022,"Mönchaltorf","G072",44,6,0,6,50,0.88,0.12,0,0.12
"986",2010,"Schwerzenbach","G090",30,0,1,1,31,0.967741935483871,0,0.032258064516129,0.032258064516129
"987",2011,"Schwerzenbach","G090",31,0,0,0,31,1,0,0,0
"988",2012,"Schwerzenbach","G090",42,0,1,1,43,0.976744186046512,0,0.0232558139534884,0.0232558139534884
"989",2013,"Schwerzenbach","G090",49,1,0,1,50,0.98,0.02,0,0.02
"990",2014,"Schwerzenbach","G090",43,1,1,2,45,0.955555555555556,0.0222222222222222,0.0222222222222222,0.0444444444444444
"991",2015,"Schwerzenbach","G090",61,0,2,2,63,0.968253968253968,0,0.0317460317460317,0.0317460317460317
"992",2016,"Schwerzenbach","G090",52,0,0,0,52,1,0,0,0
"993",2017,"Schwerzenbach","G090",40,1,2,3,43,0.930232558139535,0.0232558139534884,0.0465116279069767,0.0697674418604651
"994",2018,"Schwerzenbach","G090",62,1,1,2,64,0.96875,0.015625,0.015625,0.03125
"995",2019,"Schwerzenbach","G090",50,3,0,3,53,0.943396226415094,0.0566037735849057,0,0.0566037735849057
"996",2020,"Schwerzenbach","G090",54,1,0,1,55,0.981818181818182,0.0181818181818182,0,0.0181818181818182
"997",2021,"Schwerzenbach","G090",47,5,0,5,52,0.903846153846154,0.0961538461538462,0,0.0961538461538462
"998",2022,"Schwerzenbach","G090",50,2,0,2,52,0.961538461538462,0.0384615384615385,0,0.0384615384615385
"1000",2010,"Uster","G100",301,6,6,12,313,0.961661341853035,0.0191693290734824,0.0191693290734824,0.0383386581469649
"1001",2011,"Uster","G100",316,3,6,9,325,0.972307692307692,0.00923076923076923,0.0184615384615385,0.0276923076923077
"1002",2012,"Uster","G100",353,8,4,12,365,0.967123287671233,0.0219178082191781,0.010958904109589,0.0328767123287671
"1003",2013,"Uster","G100",337,7,8,15,352,0.957386363636364,0.0198863636363636,0.0227272727272727,0.0426136363636364
"1004",2014,"Uster","G100",329,10,6,16,345,0.953623188405797,0.0289855072463768,0.0173913043478261,0.0463768115942029
"1005",2015,"Uster","G100",370,11,5,16,386,0.958549222797927,0.0284974093264249,0.0129533678756477,0.0414507772020725
"1006",2016,"Uster","G100",329,11,4,15,344,0.956395348837209,0.0319767441860465,0.0116279069767442,0.0436046511627907
"1007",2017,"Uster","G100",338,18,2,20,358,0.94413407821229,0.0502793296089385,0.00558659217877095,0.0558659217877095
"1008",2018,"Uster","G100",385,16,1,17,402,0.95771144278607,0.0398009950248756,0.00248756218905473,0.0422885572139304
"1009",2019,"Uster","G100",331,20,0,20,351,0.943019943019943,0.056980056980057,0,0.056980056980057
"1010",2020,"Uster","G100",346,32,0,32,378,0.915343915343915,0.0846560846560847,0,0.0846560846560847
"1011",2021,"Uster","G100",299,41,0,41,340,0.879411764705882,0.120588235294118,0,0.120588235294118
"1012",2022,"Uster","G100",334,38,0,38,372,0.897849462365591,0.102150537634409,0,0.102150537634409
"1014",2010,"Volketswil","G122",164,1,14,15,179,0.916201117318436,0.00558659217877095,0.0782122905027933,0.0837988826815642
"1015",2011,"Volketswil","G122",200,2,9,11,211,0.947867298578199,0.00947867298578199,0.042654028436019,0.0521327014218009
"1016",2012,"Volketswil","G122",198,2,8,10,208,0.951923076923077,0.00961538461538462,0.0384615384615385,0.0480769230769231
"1017",2013,"Volketswil","G122",193,0,9,9,202,0.955445544554455,0,0.0445544554455446,0.0445544554455446
"1018",2014,"Volketswil","G122",189,2,3,5,194,0.974226804123711,0.0103092783505155,0.0154639175257732,0.0257731958762887
"1019",2015,"Volketswil","G122",247,3,2,5,252,0.98015873015873,0.0119047619047619,0.00793650793650794,0.0198412698412698
"1020",2016,"Volketswil","G122",212,8,2,10,222,0.954954954954955,0.036036036036036,0.00900900900900901,0.045045045045045
"1021",2017,"Volketswil","G122",213,11,6,17,230,0.926086956521739,0.0478260869565217,0.0260869565217391,0.0739130434782609
"1022",2018,"Volketswil","G122",234,12,0,12,246,0.951219512195122,0.0487804878048781,0,0.0487804878048781
"1023",2019,"Volketswil","G122",223,16,0,16,239,0.933054393305439,0.0669456066945607,0,0.0669456066945607
"1024",2020,"Volketswil","G122",190,19,0,19,209,0.909090909090909,0.0909090909090909,0,0.0909090909090909
"1025",2021,"Volketswil","G122",206,18,0,18,224,0.919642857142857,0.0803571428571429,0,0.0803571428571429
"1026",2022,"Volketswil","G122",176,13,0,13,189,0.931216931216931,0.0687830687830688,0,0.0687830687830688
"1028",2010,"Wangen-Brüttisellen","G132",74,0,3,3,77,0.961038961038961,0,0.038961038961039,0.038961038961039
"1029",2011,"Wangen-Brüttisellen","G132",69,1,3,4,73,0.945205479452055,0.0136986301369863,0.0410958904109589,0.0547945205479452
"1030",2012,"Wangen-Brüttisellen","G132",68,0,2,2,70,0.971428571428571,0,0.0285714285714286,0.0285714285714286
"1031",2013,"Wangen-Brüttisellen","G132",56,0,1,1,57,0.982456140350877,0,0.0175438596491228,0.0175438596491228
"1032",2014,"Wangen-Brüttisellen","G132",79,0,3,3,82,0.963414634146341,0,0.0365853658536585,0.0365853658536585
"1033",2015,"Wangen-Brüttisellen","G132",81,3,2,5,86,0.941860465116279,0.0348837209302326,0.0232558139534884,0.0581395348837209
"1034",2016,"Wangen-Brüttisellen","G132",78,5,2,7,85,0.917647058823529,0.0588235294117647,0.0235294117647059,0.0823529411764706
"1035",2017,"Wangen-Brüttisellen","G132",73,1,1,2,75,0.973333333333333,0.0133333333333333,0.0133333333333333,0.0266666666666667
"1036",2018,"Wangen-Brüttisellen","G132",70,5,0,5,75,0.933333333333333,0.0666666666666667,0,0.0666666666666667
"1037",2019,"Wangen-Brüttisellen","G132",88,3,0,3,91,0.967032967032967,0.032967032967033,0,0.032967032967033
"1038",2020,"Wangen-Brüttisellen","G132",74,7,0,7,81,0.91358024691358,0.0864197530864197,0,0.0864197530864197
"1039",2021,"Wangen-Brüttisellen","G132",73,5,0,5,78,0.935897435897436,0.0641025641025641,0,0.0641025641025641
"1040",2022,"Wangen-Brüttisellen","G132",85,5,0,5,90,0.944444444444444,0.0555555555555556,0,0.0555555555555556
"1042",2010,"Bauma","H012",36,0,1,1,37,0.972972972972973,0,0.027027027027027,0.027027027027027
"1043",2011,"Bauma","H012",41,0,4,4,45,0.911111111111111,0,0.0888888888888889,0.0888888888888889
"1044",2012,"Bauma","H012",35,3,1,4,39,0.897435897435897,0.0769230769230769,0.0256410256410256,0.102564102564103
"1045",2013,"Bauma","H012",30,1,1,2,32,0.9375,0.03125,0.03125,0.0625
"1046",2014,"Bauma","H012",49,2,0,2,51,0.96078431372549,0.0392156862745098,0,0.0392156862745098
"1048",2010,"Fehraltorf","H022",59,1,2,3,62,0.951612903225806,0.0161290322580645,0.032258064516129,0.0483870967741935
"1049",2011,"Fehraltorf","H022",62,0,0,0,62,1,0,0,0
"1050",2012,"Fehraltorf","H022",64,4,1,5,69,0.927536231884058,0.0579710144927536,0.0144927536231884,0.072463768115942
"1051",2013,"Fehraltorf","H022",76,2,2,4,80,0.95,0.025,0.025,0.05
"1052",2014,"Fehraltorf","H022",62,2,2,4,66,0.939393939393939,0.0303030303030303,0.0303030303030303,0.0606060606060606
"1053",2015,"Fehraltorf","H022",70,3,0,3,73,0.958904109589041,0.0410958904109589,0,0.0410958904109589
"1054",2016,"Fehraltorf","H022",75,1,1,2,77,0.974025974025974,0.012987012987013,0.012987012987013,0.025974025974026
"1055",2017,"Fehraltorf","H022",76,6,0,6,82,0.926829268292683,0.0731707317073171,0,0.0731707317073171
"1056",2018,"Fehraltorf","H022",83,4,1,5,88,0.943181818181818,0.0454545454545455,0.0113636363636364,0.0568181818181818
"1057",2019,"Fehraltorf","H022",69,9,0,9,78,0.884615384615385,0.115384615384615,0,0.115384615384615
"1058",2020,"Fehraltorf","H022",64,7,0,7,71,0.901408450704225,0.0985915492957746,0,0.0985915492957746
"1059",2021,"Fehraltorf","H022",64,9,0,9,73,0.876712328767123,0.123287671232877,0,0.123287671232877
"1060",2022,"Fehraltorf","H022",70,10,0,10,80,0.875,0.125,0,0.125
"1062",2010,"Hittnau","H032",34,1,0,1,35,0.971428571428571,0.0285714285714286,0,0.0285714285714286
"1063",2011,"Hittnau","H032",33,3,3,6,39,0.846153846153846,0.0769230769230769,0.0769230769230769,0.153846153846154
"1064",2012,"Hittnau","H032",40,1,1,2,42,0.952380952380952,0.0238095238095238,0.0238095238095238,0.0476190476190476
"1065",2013,"Hittnau","H032",45,1,1,2,47,0.957446808510638,0.0212765957446809,0.0212765957446809,0.0425531914893617
"1066",2014,"Hittnau","H032",41,1,0,1,42,0.976190476190476,0.0238095238095238,0,0.0238095238095238
"1067",2015,"Hittnau","H032",45,1,0,1,46,0.978260869565217,0.0217391304347826,0,0.0217391304347826
"1068",2016,"Hittnau","H032",32,4,0,4,36,0.888888888888889,0.111111111111111,0,0.111111111111111
"1069",2017,"Hittnau","H032",33,2,0,2,35,0.942857142857143,0.0571428571428571,0,0.0571428571428571
"1070",2018,"Hittnau","H032",28,4,0,4,32,0.875,0.125,0,0.125
"1071",2019,"Hittnau","H032",35,8,0,8,43,0.813953488372093,0.186046511627907,0,0.186046511627907
"1072",2020,"Hittnau","H032",37,5,0,5,42,0.880952380952381,0.119047619047619,0,0.119047619047619
"1073",2021,"Hittnau","H032",45,10,0,10,55,0.818181818181818,0.181818181818182,0,0.181818181818182
"1074",2022,"Hittnau","H032",37,8,0,8,45,0.822222222222222,0.177777777777778,0,0.177777777777778
"1076",2010,"Illnau-Effretikon","H042",136,5,6,11,147,0.925170068027211,0.0340136054421769,0.0408163265306122,0.0748299319727891
"1077",2011,"Illnau-Effretikon","H042",147,3,8,11,158,0.930379746835443,0.0189873417721519,0.0506329113924051,0.069620253164557
"1078",2012,"Illnau-Effretikon","H042",150,3,2,5,155,0.967741935483871,0.0193548387096774,0.0129032258064516,0.032258064516129
"1079",2013,"Illnau-Effretikon","H042",150,8,1,9,159,0.943396226415094,0.050314465408805,0.00628930817610063,0.0566037735849057
"1080",2014,"Illnau-Effretikon","H042",151,1,1,2,153,0.986928104575163,0.0065359477124183,0.0065359477124183,0.0130718954248366
"1081",2015,"Illnau-Effretikon","H042",176,2,1,3,179,0.983240223463687,0.0111731843575419,0.00558659217877095,0.0167597765363128
"1082",2016,"Illnau-Effretikon","H042",173,8,2,10,183,0.945355191256831,0.0437158469945355,0.0109289617486339,0.0546448087431694
"1083",2017,"Illnau-Effretikon","H042",165,9,3,12,177,0.932203389830508,0.0508474576271186,0.0169491525423729,0.0677966101694915
"1084",2018,"Illnau-Effretikon","H042",152,8,0,8,160,0.95,0.05,0,0.05
"1085",2019,"Illnau-Effretikon","H042",162,10,0,10,172,0.941860465116279,0.0581395348837209,0,0.0581395348837209
"1086",2020,"Illnau-Effretikon","H042",156,18,0,18,174,0.896551724137931,0.103448275862069,0,0.103448275862069
"1087",2021,"Illnau-Effretikon","H042",156,13,0,13,169,0.923076923076923,0.0769230769230769,0,0.0769230769230769
"1088",2022,"Illnau-Effretikon","H042",164,11,0,11,175,0.937142857142857,0.0628571428571429,0,0.0628571428571429
"1090",2010,"Kyburg","H050",1,1,1,2,3,0.333333333333333,0.333333333333333,0.333333333333333,0.666666666666667
"1091",2011,"Kyburg","H050",2,0,1,1,3,0.666666666666667,0,0.333333333333333,0.333333333333333
"1092",2012,"Kyburg","H050",3,0,1,1,4,0.75,0,0.25,0.25
"1093",2013,"Kyburg","H050",3,0,0,0,3,1,0,0,0
"1094",2014,"Kyburg","H050",4,0,0,0,4,1,0,0,0
"1095",2015,"Kyburg","H050",8,0,0,0,8,1,0,0,0
"1097",2010,"Lindau","H062",58,4,0,4,62,0.935483870967742,0.0645161290322581,0,0.0645161290322581
"1098",2011,"Lindau","H062",46,0,0,0,46,1,0,0,0
"1099",2012,"Lindau","H062",38,2,3,5,43,0.883720930232558,0.0465116279069767,0.0697674418604651,0.116279069767442
"1100",2013,"Lindau","H062",56,3,1,4,60,0.933333333333333,0.05,0.0166666666666667,0.0666666666666667
"1101",2014,"Lindau","H062",48,2,1,3,51,0.941176470588235,0.0392156862745098,0.0196078431372549,0.0588235294117647
"1102",2015,"Lindau","H062",54,3,0,3,57,0.947368421052632,0.0526315789473684,0,0.0526315789473684
"1103",2016,"Lindau","H062",57,0,0,0,57,1,0,0,0
"1104",2017,"Lindau","H062",49,5,0,5,54,0.907407407407407,0.0925925925925926,0,0.0925925925925926
"1105",2018,"Lindau","H062",68,3,0,3,71,0.957746478873239,0.0422535211267606,0,0.0422535211267606
"1106",2019,"Lindau","H062",54,4,0,4,58,0.931034482758621,0.0689655172413793,0,0.0689655172413793
"1107",2020,"Lindau","H062",53,6,0,6,59,0.898305084745763,0.101694915254237,0,0.101694915254237
"1108",2021,"Lindau","H062",60,3,0,3,63,0.952380952380952,0.0476190476190476,0,0.0476190476190476
"1109",2022,"Lindau","H062",56,12,0,12,68,0.823529411764706,0.176470588235294,0,0.176470588235294
"1111",2010,"Pfäffikon","H072",100,1,0,1,101,0.99009900990099,0.0099009900990099,0,0.0099009900990099
"1112",2011,"Pfäffikon","H072",106,0,1,1,107,0.990654205607477,0,0.00934579439252336,0.00934579439252336
"1113",2012,"Pfäffikon","H072",106,5,3,8,114,0.929824561403509,0.043859649122807,0.0263157894736842,0.0701754385964912
"1114",2013,"Pfäffikon","H072",118,2,3,5,123,0.959349593495935,0.016260162601626,0.024390243902439,0.040650406504065
"1115",2014,"Pfäffikon","H072",96,4,3,7,103,0.932038834951456,0.0388349514563107,0.029126213592233,0.0679611650485437
"1116",2015,"Pfäffikon","H072",128,6,2,8,136,0.941176470588235,0.0441176470588235,0.0147058823529412,0.0588235294117647
"1117",2016,"Pfäffikon","H072",111,12,0,12,123,0.902439024390244,0.0975609756097561,0,0.0975609756097561
"1118",2017,"Pfäffikon","H072",110,10,0,10,120,0.916666666666667,0.0833333333333333,0,0.0833333333333333
"1119",2018,"Pfäffikon","H072",125,12,0,12,137,0.912408759124088,0.0875912408759124,0,0.0875912408759124
"1120",2019,"Pfäffikon","H072",111,18,0,18,129,0.86046511627907,0.13953488372093,0,0.13953488372093
"1121",2020,"Pfäffikon","H072",113,27,0,27,140,0.807142857142857,0.192857142857143,0,0.192857142857143
"1122",2021,"Pfäffikon","H072",95,19,0,19,114,0.833333333333333,0.166666666666667,0,0.166666666666667
"1123",2022,"Pfäffikon","H072",95,18,0,18,113,0.84070796460177,0.15929203539823,0,0.15929203539823
"1125",2010,"Russikon","H092",50,1,0,1,51,0.980392156862745,0.0196078431372549,0,0.0196078431372549
"1126",2011,"Russikon","H092",45,0,5,5,50,0.9,0,0.1,0.1
"1127",2012,"Russikon","H092",47,0,1,1,48,0.979166666666667,0,0.0208333333333333,0.0208333333333333
"1128",2013,"Russikon","H092",60,0,0,0,60,1,0,0,0
"1129",2014,"Russikon","H092",43,0,0,0,43,1,0,0,0
"1130",2015,"Russikon","H092",42,0,0,0,42,1,0,0,0
"1131",2016,"Russikon","H092",57,4,0,4,61,0.934426229508197,0.0655737704918033,0,0.0655737704918033
"1132",2017,"Russikon","H092",45,5,0,5,50,0.9,0.1,0,0.1
"1133",2018,"Russikon","H092",37,6,0,6,43,0.86046511627907,0.13953488372093,0,0.13953488372093
"1134",2019,"Russikon","H092",52,12,0,12,64,0.8125,0.1875,0,0.1875
"1135",2020,"Russikon","H092",28,2,0,2,30,0.933333333333333,0.0666666666666667,0,0.0666666666666667
"1136",2021,"Russikon","H092",38,14,0,14,52,0.730769230769231,0.269230769230769,0,0.269230769230769
"1137",2022,"Russikon","H092",43,4,0,4,47,0.914893617021277,0.0851063829787234,0,0.0851063829787234
"1138",2010,"Sternenberg","H100",5,0,0,0,5,1,0,0,0
"1139",2011,"Sternenberg","H100",6,0,0,0,6,1,0,0,0
"1140",2012,"Sternenberg","H100",3,0,0,0,3,1,0,0,0
"1141",2013,"Sternenberg","H100",0,0,1,1,1,0,0,1,1
"1142",2014,"Sternenberg","H100",3,0,0,0,3,1,0,0,0
"1144",2010,"Weisslingen","H112",30,3,3,6,36,0.833333333333333,0.0833333333333333,0.0833333333333333,0.166666666666667
"1145",2011,"Weisslingen","H112",44,1,1,2,46,0.956521739130435,0.0217391304347826,0.0217391304347826,0.0434782608695652
"1146",2012,"Weisslingen","H112",31,0,3,3,34,0.911764705882353,0,0.0882352941176471,0.0882352941176471
"1147",2013,"Weisslingen","H112",34,0,0,0,34,1,0,0,0
"1148",2014,"Weisslingen","H112",31,1,1,2,33,0.939393939393939,0.0303030303030303,0.0303030303030303,0.0606060606060606
"1149",2015,"Weisslingen","H112",31,2,3,5,36,0.861111111111111,0.0555555555555556,0.0833333333333333,0.138888888888889
"1150",2016,"Weisslingen","H112",39,2,0,2,41,0.951219512195122,0.0487804878048781,0,0.0487804878048781
"1151",2017,"Weisslingen","H112",27,5,1,6,33,0.818181818181818,0.151515151515152,0.0303030303030303,0.181818181818182
"1152",2018,"Weisslingen","H112",27,4,0,4,31,0.870967741935484,0.129032258064516,0,0.129032258064516
"1153",2019,"Weisslingen","H112",31,6,0,6,37,0.837837837837838,0.162162162162162,0,0.162162162162162
"1154",2020,"Weisslingen","H112",29,3,0,3,32,0.90625,0.09375,0,0.09375
"1155",2021,"Weisslingen","H112",29,3,0,3,32,0.90625,0.09375,0,0.09375
"1156",2022,"Weisslingen","H112",37,6,0,6,43,0.86046511627907,0.13953488372093,0,0.13953488372093
"1158",2010,"Wila","H130",16,0,1,1,17,0.941176470588235,0,0.0588235294117647,0.0588235294117647
"1159",2011,"Wila","H130",15,0,0,0,15,1,0,0,0
"1160",2012,"Wila","H130",19,1,0,1,20,0.95,0.05,0,0.05
"1161",2013,"Wila","H130",16,0,0,0,16,1,0,0,0
"1162",2014,"Wila","H130",21,0,0,0,21,1,0,0,0
"1163",2015,"Wila","H130",15,1,0,1,16,0.9375,0.0625,0,0.0625
"1164",2016,"Wila","H130",20,1,0,1,21,0.952380952380952,0.0476190476190476,0,0.0476190476190476
"1165",2017,"Wila","H130",29,1,0,1,30,0.966666666666667,0.0333333333333333,0,0.0333333333333333
"1166",2018,"Wila","H130",11,1,0,1,12,0.916666666666667,0.0833333333333333,0,0.0833333333333333
"1167",2019,"Wila","H130",20,4,0,4,24,0.833333333333333,0.166666666666667,0,0.166666666666667
"1168",2020,"Wila","H130",15,1,0,1,16,0.9375,0.0625,0,0.0625
"1169",2021,"Wila","H130",30,3,0,3,33,0.909090909090909,0.0909090909090909,0,0.0909090909090909
"1170",2022,"Wila","H130",27,1,0,1,28,0.964285714285714,0.0357142857142857,0,0.0357142857142857
"1172",2010,"Wildberg","H150",4,0,1,1,5,0.8,0,0.2,0.2
"1173",2011,"Wildberg","H150",13,1,1,2,15,0.866666666666667,0.0666666666666667,0.0666666666666667,0.133333333333333
"1174",2012,"Wildberg","H150",15,2,0,2,17,0.882352941176471,0.117647058823529,0,0.117647058823529
"1175",2013,"Wildberg","H150",16,0,0,0,16,1,0,0,0
"1176",2014,"Wildberg","H150",16,0,0,0,16,1,0,0,0
"1177",2015,"Wildberg","H150",12,0,0,0,12,1,0,0,0
"1178",2016,"Wildberg","H150",10,0,0,0,10,1,0,0,0
"1179",2017,"Wildberg","H150",12,2,0,2,14,0.857142857142857,0.142857142857143,0,0.142857142857143
"1180",2018,"Wildberg","H150",14,0,0,0,14,1,0,0,0
"1181",2019,"Wildberg","H150",4,2,0,2,6,0.666666666666667,0.333333333333333,0,0.333333333333333
"1182",2020,"Wildberg","H150",13,1,0,1,14,0.928571428571429,0.0714285714285714,0,0.0714285714285714
"1183",2021,"Wildberg","H150",7,1,0,1,8,0.875,0.125,0,0.125
"1184",2022,"Wildberg","H150",12,0,0,0,12,1,0,0,0
"1185",2015,"Bauma-Sternenberg","H162",41,0,0,0,41,1,0,0,0
"1186",2016,"Bauma-Sternenberg","H162",32,1,0,1,33,0.96969696969697,0.0303030303030303,0,0.0303030303030303
"1187",2017,"Bauma-Sternenberg","H162",42,3,0,3,45,0.933333333333333,0.0666666666666667,0,0.0666666666666667
"1188",2018,"Bauma-Sternenberg","H162",49,1,0,1,50,0.98,0.02,0,0.02
"1189",2019,"Bauma-Sternenberg","H162",54,6,0,6,60,0.9,0.1,0,0.1
"1190",2020,"Bauma-Sternenberg","H162",53,3,0,3,56,0.946428571428571,0.0535714285714286,0,0.0535714285714286
"1191",2021,"Bauma-Sternenberg","H162",52,6,0,6,58,0.896551724137931,0.103448275862069,0,0.103448275862069
"1192",2022,"Bauma-Sternenberg","H162",53,7,0,7,60,0.883333333333333,0.116666666666667,0,0.116666666666667
"1194",2010,"Winterthur-Stadt","I012",135,1,7,8,143,0.944055944055944,0.00699300699300699,0.048951048951049,0.0559440559440559
"1195",2011,"Winterthur-Stadt","I012",126,1,4,5,131,0.961832061068702,0.00763358778625954,0.0305343511450382,0.0381679389312977
"1196",2012,"Winterthur-Stadt","I012",138,0,6,6,144,0.958333333333333,0,0.0416666666666667,0.0416666666666667
"1197",2013,"Winterthur-Stadt","I012",135,3,6,9,144,0.9375,0.0208333333333333,0.0416666666666667,0.0625
"1199",2010,"Winterthur-Oberwinterthur","I022",222,3,4,7,229,0.96943231441048,0.0131004366812227,0.0174672489082969,0.0305676855895196
"1200",2011,"Winterthur-Oberwinterthur","I022",205,2,2,4,209,0.980861244019139,0.00956937799043062,0.00956937799043062,0.0191387559808612
"1201",2012,"Winterthur-Oberwinterthur","I022",228,1,6,7,235,0.970212765957447,0.00425531914893617,0.025531914893617,0.0297872340425532
"1202",2013,"Winterthur-Oberwinterthur","I022",246,5,6,11,257,0.957198443579767,0.0194552529182879,0.0233463035019455,0.0428015564202335
"1204",2010,"Winterthur-Seen","I032",169,2,6,8,177,0.954802259887006,0.0112994350282486,0.0338983050847458,0.0451977401129944
"1205",2011,"Winterthur-Seen","I032",166,7,5,12,178,0.932584269662921,0.0393258426966292,0.0280898876404494,0.0674157303370786
"1206",2012,"Winterthur-Seen","I032",170,1,4,5,175,0.971428571428571,0.00571428571428571,0.0228571428571429,0.0285714285714286
"1207",2013,"Winterthur-Seen","I032",148,3,7,10,158,0.936708860759494,0.0189873417721519,0.0443037974683544,0.0632911392405063
"1209",2010,"Winterthur-Töss","I042",95,1,3,4,99,0.95959595959596,0.0101010101010101,0.0303030303030303,0.0404040404040404
"1210",2011,"Winterthur-Töss","I042",122,1,5,6,128,0.953125,0.0078125,0.0390625,0.046875
"1211",2012,"Winterthur-Töss","I042",104,3,1,4,108,0.962962962962963,0.0277777777777778,0.00925925925925926,0.037037037037037
"1212",2013,"Winterthur-Töss","I042",114,2,3,5,119,0.957983193277311,0.0168067226890756,0.0252100840336134,0.0420168067226891
"1214",2010,"Winterthur-Veltheim","I052",77,2,0,2,79,0.974683544303797,0.0253164556962025,0,0.0253164556962025
"1215",2011,"Winterthur-Veltheim","I052",82,1,0,1,83,0.987951807228916,0.0120481927710843,0,0.0120481927710843
"1216",2012,"Winterthur-Veltheim","I052",72,0,1,1,73,0.986301369863014,0,0.0136986301369863,0.0136986301369863
"1217",2013,"Winterthur-Veltheim","I052",94,1,1,2,96,0.979166666666667,0.0104166666666667,0.0104166666666667,0.0208333333333333
"1219",2010,"Winterthur-Wülflingen","I062",131,1,4,5,136,0.963235294117647,0.00735294117647059,0.0294117647058824,0.0367647058823529
"1220",2011,"Winterthur-Wülflingen","I062",136,1,5,6,142,0.957746478873239,0.00704225352112676,0.0352112676056338,0.0422535211267606
"1221",2012,"Winterthur-Wülflingen","I062",129,1,4,5,134,0.962686567164179,0.00746268656716418,0.0298507462686567,0.0373134328358209
"1222",2013,"Winterthur-Wülflingen","I062",152,4,1,5,157,0.968152866242038,0.0254777070063694,0.00636942675159236,0.0318471337579618
"1224",2010,"Winterthur-Mattenbach","I072",115,2,5,7,122,0.942622950819672,0.0163934426229508,0.040983606557377,0.0573770491803279
"1225",2011,"Winterthur-Mattenbach","I072",136,2,2,4,140,0.971428571428571,0.0142857142857143,0.0142857142857143,0.0285714285714286
"1226",2012,"Winterthur-Mattenbach","I072",114,3,6,9,123,0.926829268292683,0.024390243902439,0.0487804878048781,0.0731707317073171
"1227",2013,"Winterthur-Mattenbach","I072",114,1,1,2,116,0.982758620689655,0.00862068965517241,0.00862068965517241,0.0172413793103448
"1229",2010,"Altikon","I080",4,0,0,0,4,1,0,0,0
"1230",2011,"Altikon","I080",6,1,0,1,7,0.857142857142857,0.142857142857143,0,0.142857142857143
"1231",2012,"Altikon","I080",4,1,0,1,5,0.8,0.2,0,0.2
"1232",2013,"Altikon","I080",8,1,0,1,9,0.888888888888889,0.111111111111111,0,0.111111111111111
"1233",2014,"Altikon","I080",13,0,0,0,13,1,0,0,0
"1234",2015,"Altikon","I080",7,0,0,0,7,1,0,0,0
"1235",2016,"Altikon","I080",6,2,0,2,8,0.75,0.25,0,0.25
"1236",2017,"Altikon","I080",5,0,0,0,5,1,0,0,0
"1237",2018,"Altikon","I080",3,1,1,2,5,0.6,0.2,0.2,0.4
"1238",2019,"Altikon","I080",9,1,0,1,10,0.9,0.1,0,0.1
"1239",2020,"Altikon","I080",9,0,0,0,9,1,0,0,0
"1240",2021,"Altikon","I080",5,1,0,1,6,0.833333333333333,0.166666666666667,0,0.166666666666667
"1241",2022,"Altikon","I080",12,0,0,0,12,1,0,0,0
"1243",2010,"Bertschikon","I090",11,0,0,0,11,1,0,0,0
"1245",2010,"Brütten","I100",14,1,0,1,15,0.933333333333333,0.0666666666666667,0,0.0666666666666667
"1246",2011,"Brütten","I100",19,0,0,0,19,1,0,0,0
"1247",2012,"Brütten","I100",17,0,0,0,17,1,0,0,0
"1248",2013,"Brütten","I100",23,0,1,1,24,0.958333333333333,0,0.0416666666666667,0.0416666666666667
"1249",2014,"Brütten","I100",19,0,1,1,20,0.95,0,0.05,0.05
"1250",2015,"Brütten","I100",14,1,1,2,16,0.875,0.0625,0.0625,0.125
"1251",2016,"Brütten","I100",22,1,0,1,23,0.956521739130435,0.0434782608695652,0,0.0434782608695652
"1252",2017,"Brütten","I100",18,1,0,1,19,0.947368421052632,0.0526315789473684,0,0.0526315789473684
"1253",2018,"Brütten","I100",26,0,0,0,26,1,0,0,0
"1254",2019,"Brütten","I100",26,2,0,2,28,0.928571428571429,0.0714285714285714,0,0.0714285714285714
"1255",2020,"Brütten","I100",23,1,0,1,24,0.958333333333333,0.0416666666666667,0,0.0416666666666667
"1256",2021,"Brütten","I100",20,4,0,4,24,0.833333333333333,0.166666666666667,0,0.166666666666667
"1257",2022,"Brütten","I100",22,3,0,3,25,0.88,0.12,0,0.12
"1259",2010,"Dägerlen","I110",18,1,1,2,20,0.9,0.05,0.05,0.1
"1260",2011,"Dägerlen","I110",16,1,1,2,18,0.888888888888889,0.0555555555555556,0.0555555555555556,0.111111111111111
"1261",2012,"Dägerlen","I110",10,1,0,1,11,0.909090909090909,0.0909090909090909,0,0.0909090909090909
"1262",2013,"Dägerlen","I110",12,0,1,1,13,0.923076923076923,0,0.0769230769230769,0.0769230769230769
"1263",2014,"Dägerlen","I110",14,0,0,0,14,1,0,0,0
"1264",2015,"Dägerlen","I110",15,2,0,2,17,0.882352941176471,0.117647058823529,0,0.117647058823529
"1265",2016,"Dägerlen","I110",8,0,0,0,8,1,0,0,0
"1266",2017,"Dägerlen","I110",5,3,0,3,8,0.625,0.375,0,0.375
"1267",2018,"Dägerlen","I110",10,0,0,0,10,1,0,0,0
"1268",2019,"Dägerlen","I110",5,1,0,1,6,0.833333333333333,0.166666666666667,0,0.166666666666667
"1269",2020,"Dägerlen","I110",10,0,0,0,10,1,0,0,0
"1270",2021,"Dägerlen","I110",8,1,0,1,9,0.888888888888889,0.111111111111111,0,0.111111111111111
"1271",2022,"Dägerlen","I110",5,0,0,0,5,1,0,0,0
"1273",2010,"Dättlikon","I120",12,0,0,0,12,1,0,0,0
"1274",2011,"Dättlikon","I120",9,0,0,0,9,1,0,0,0
"1275",2012,"Dättlikon","I120",13,0,0,0,13,1,0,0,0
"1276",2013,"Dättlikon","I120",14,0,0,0,14,1,0,0,0
"1277",2014,"Dättlikon","I120",8,2,0,2,10,0.8,0.2,0,0.2
"1278",2015,"Dättlikon","I120",8,0,0,0,8,1,0,0,0
"1279",2016,"Dättlikon","I120",9,0,0,0,9,1,0,0,0
"1280",2017,"Dättlikon","I120",10,1,0,1,11,0.909090909090909,0.0909090909090909,0,0.0909090909090909
"1281",2018,"Dättlikon","I120",11,1,0,1,12,0.916666666666667,0.0833333333333333,0,0.0833333333333333
"1282",2019,"Dättlikon","I120",5,1,0,1,6,0.833333333333333,0.166666666666667,0,0.166666666666667
"1283",2020,"Dättlikon","I120",7,1,0,1,8,0.875,0.125,0,0.125
"1284",2021,"Dättlikon","I120",7,2,0,2,9,0.777777777777778,0.222222222222222,0,0.222222222222222
"1285",2022,"Dättlikon","I120",5,3,0,3,8,0.625,0.375,0,0.375
"1287",2010,"Dinhard","I130",14,0,0,0,14,1,0,0,0
"1288",2011,"Dinhard","I130",20,0,0,0,20,1,0,0,0
"1289",2012,"Dinhard","I130",13,1,0,1,14,0.928571428571429,0.0714285714285714,0,0.0714285714285714
"1290",2013,"Dinhard","I130",17,2,1,3,20,0.85,0.1,0.05,0.15
"1291",2014,"Dinhard","I130",25,1,0,1,26,0.961538461538462,0.0384615384615385,0,0.0384615384615385
"1292",2015,"Dinhard","I130",16,0,0,0,16,1,0,0,0
"1293",2016,"Dinhard","I130",18,4,0,4,22,0.818181818181818,0.181818181818182,0,0.181818181818182
"1294",2017,"Dinhard","I130",17,2,0,2,19,0.894736842105263,0.105263157894737,0,0.105263157894737
"1295",2018,"Dinhard","I130",23,3,0,3,26,0.884615384615385,0.115384615384615,0,0.115384615384615
"1296",2019,"Dinhard","I130",18,2,0,2,20,0.9,0.1,0,0.1
"1297",2020,"Dinhard","I130",17,2,0,2,19,0.894736842105263,0.105263157894737,0,0.105263157894737
"1298",2021,"Dinhard","I130",17,5,0,5,22,0.772727272727273,0.227272727272727,0,0.227272727272727
"1299",2022,"Dinhard","I130",21,4,0,4,25,0.84,0.16,0,0.16
"1301",2010,"Elgg","I140",27,0,0,0,27,1,0,0,0
"1302",2011,"Elgg","I140",40,0,2,2,42,0.952380952380952,0,0.0476190476190476,0.0476190476190476
"1303",2012,"Elgg","I140",43,2,1,3,46,0.934782608695652,0.0434782608695652,0.0217391304347826,0.0652173913043478
"1304",2013,"Elgg","I140",43,2,2,4,47,0.914893617021277,0.0425531914893617,0.0425531914893617,0.0851063829787234
"1305",2014,"Elgg","I140",40,0,2,2,42,0.952380952380952,0,0.0476190476190476,0.0476190476190476
"1306",2015,"Elgg","I140",49,2,2,4,53,0.924528301886792,0.0377358490566038,0.0377358490566038,0.0754716981132075
"1307",2016,"Elgg","I140",40,3,1,4,44,0.909090909090909,0.0681818181818182,0.0227272727272727,0.0909090909090909
"1308",2017,"Elgg","I140",37,0,0,0,37,1,0,0,0
"1309",2018,"Elgg","I143",59,6,0,6,65,0.907692307692308,0.0923076923076923,0,0.0923076923076923
"1310",2019,"Elgg","I143",46,2,0,2,48,0.958333333333333,0.0416666666666667,0,0.0416666666666667
"1311",2020,"Elgg","I143",56,2,0,2,58,0.96551724137931,0.0344827586206897,0,0.0344827586206897
"1312",2021,"Elgg","I143",51,16,0,16,67,0.761194029850746,0.238805970149254,0,0.238805970149254
"1313",2022,"Elgg","I143",36,5,0,5,41,0.878048780487805,0.121951219512195,0,0.121951219512195
"1315",2010,"Ellikon an der Thur","I160",13,0,0,0,13,1,0,0,0
"1316",2011,"Ellikon an der Thur","I160",5,0,0,0,5,1,0,0,0
"1317",2012,"Ellikon an der Thur","I160",10,1,0,1,11,0.909090909090909,0.0909090909090909,0,0.0909090909090909
"1318",2013,"Ellikon an der Thur","I160",10,1,1,2,12,0.833333333333333,0.0833333333333333,0.0833333333333333,0.166666666666667
"1319",2014,"Ellikon an der Thur","I160",10,0,0,0,10,1,0,0,0
"1320",2015,"Ellikon an der Thur","I160",11,0,0,0,11,1,0,0,0
"1321",2016,"Ellikon an der Thur","I160",14,0,0,0,14,1,0,0,0
"1322",2017,"Ellikon an der Thur","I160",10,0,0,0,10,1,0,0,0
"1323",2018,"Ellikon an der Thur","I160",12,1,0,1,13,0.923076923076923,0.0769230769230769,0,0.0769230769230769
"1324",2019,"Ellikon an der Thur","I160",6,2,0,2,8,0.75,0.25,0,0.25
"1325",2020,"Ellikon an der Thur","I160",10,2,0,2,12,0.833333333333333,0.166666666666667,0,0.166666666666667
"1326",2021,"Ellikon an der Thur","I160",10,0,0,0,10,1,0,0,0
"1327",2022,"Ellikon an der Thur","I160",10,0,0,0,10,1,0,0,0
"1329",2010,"Elsau","I170",35,1,0,1,36,0.972222222222222,0.0277777777777778,0,0.0277777777777778
"1330",2011,"Elsau","I170",30,1,1,2,32,0.9375,0.03125,0.03125,0.0625
"1331",2012,"Elsau","I170",28,3,1,4,32,0.875,0.09375,0.03125,0.125
"1332",2013,"Elsau","I170",33,0,0,0,33,1,0,0,0
"1333",2014,"Elsau","I170",34,1,0,1,35,0.971428571428571,0.0285714285714286,0,0.0285714285714286
"1334",2015,"Elsau","I170",38,1,1,2,40,0.95,0.025,0.025,0.05
"1335",2016,"Elsau","I170",42,1,1,2,44,0.954545454545455,0.0227272727272727,0.0227272727272727,0.0454545454545455
"1336",2017,"Elsau","I170",41,1,0,1,42,0.976190476190476,0.0238095238095238,0,0.0238095238095238
"1337",2018,"Elsau","I170",41,3,0,3,44,0.931818181818182,0.0681818181818182,0,0.0681818181818182
"1339",2010,"Hagenbuch","I190",13,0,0,0,13,1,0,0,0
"1340",2011,"Hagenbuch","I190",10,0,0,0,10,1,0,0,0
"1341",2012,"Hagenbuch","I190",9,0,1,1,10,0.9,0,0.1,0.1
"1342",2013,"Hagenbuch","I190",18,0,0,0,18,1,0,0,0
"1343",2014,"Hagenbuch","I190",9,0,0,0,9,1,0,0,0
"1344",2015,"Hagenbuch","I190",13,0,0,0,13,1,0,0,0
"1345",2016,"Hagenbuch","I190",9,1,0,1,10,0.9,0.1,0,0.1
"1346",2017,"Hagenbuch","I190",14,0,0,0,14,1,0,0,0
"1347",2018,"Hagenbuch","I190",12,1,0,1,13,0.923076923076923,0.0769230769230769,0,0.0769230769230769
"1348",2019,"Hagenbuch","I190",8,0,0,0,8,1,0,0,0
"1349",2020,"Hagenbuch","I190",8,1,0,1,9,0.888888888888889,0.111111111111111,0,0.111111111111111
"1350",2021,"Hagenbuch","I190",13,2,0,2,15,0.866666666666667,0.133333333333333,0,0.133333333333333
"1351",2022,"Hagenbuch","I190",13,5,0,5,18,0.722222222222222,0.277777777777778,0,0.277777777777778
"1353",2010,"Hettlingen","I200",31,2,1,3,34,0.911764705882353,0.0588235294117647,0.0294117647058824,0.0882352941176471
"1354",2011,"Hettlingen","I200",37,0,1,1,38,0.973684210526316,0,0.0263157894736842,0.0263157894736842
"1355",2012,"Hettlingen","I200",23,0,2,2,25,0.92,0,0.08,0.08
"1356",2013,"Hettlingen","I200",32,0,1,1,33,0.96969696969697,0,0.0303030303030303,0.0303030303030303
"1357",2014,"Hettlingen","I200",29,0,0,0,29,1,0,0,0
"1358",2015,"Hettlingen","I200",36,0,1,1,37,0.972972972972973,0,0.027027027027027,0.027027027027027
"1359",2016,"Hettlingen","I200",27,6,1,7,34,0.794117647058823,0.176470588235294,0.0294117647058824,0.205882352941176
"1360",2017,"Hettlingen","I200",29,1,0,1,30,0.966666666666667,0.0333333333333333,0,0.0333333333333333
"1361",2018,"Hettlingen","I200",30,5,0,5,35,0.857142857142857,0.142857142857143,0,0.142857142857143
"1362",2019,"Hettlingen","I200",35,3,0,3,38,0.921052631578947,0.0789473684210526,0,0.0789473684210526
"1363",2020,"Hettlingen","I200",22,8,0,8,30,0.733333333333333,0.266666666666667,0,0.266666666666667
"1364",2021,"Hettlingen","I200",21,3,0,3,24,0.875,0.125,0,0.125
"1365",2022,"Hettlingen","I200",41,8,0,8,49,0.836734693877551,0.163265306122449,0,0.163265306122449
"1367",2010,"Hofstetten","I210",7,0,0,0,7,1,0,0,0
"1368",2011,"Hofstetten","I210",5,0,0,0,5,1,0,0,0
"1369",2012,"Hofstetten","I210",5,0,0,0,5,1,0,0,0
"1370",2013,"Hofstetten","I210",7,0,0,0,7,1,0,0,0
"1371",2014,"Hofstetten","I210",8,0,0,0,8,1,0,0,0
"1372",2015,"Hofstetten","I210",8,0,0,0,8,1,0,0,0
"1373",2016,"Hofstetten","I210",11,0,0,0,11,1,0,0,0
"1374",2017,"Hofstetten","I210",2,0,0,0,2,1,0,0,0
"1376",2010,"Neftenbach","I222",53,2,2,4,57,0.929824561403509,0.0350877192982456,0.0350877192982456,0.0701754385964912
"1377",2011,"Neftenbach","I222",58,2,1,3,61,0.950819672131147,0.0327868852459016,0.0163934426229508,0.0491803278688525
"1378",2012,"Neftenbach","I222",71,2,2,4,75,0.946666666666667,0.0266666666666667,0.0266666666666667,0.0533333333333333
"1379",2013,"Neftenbach","I222",80,2,3,5,85,0.941176470588235,0.0235294117647059,0.0352941176470588,0.0588235294117647
"1380",2014,"Neftenbach","I222",73,3,1,4,77,0.948051948051948,0.038961038961039,0.012987012987013,0.051948051948052
"1381",2015,"Neftenbach","I222",73,4,0,4,77,0.948051948051948,0.051948051948052,0,0.051948051948052
"1382",2016,"Neftenbach","I222",55,3,0,3,58,0.948275862068966,0.0517241379310345,0,0.0517241379310345
"1383",2017,"Neftenbach","I222",66,4,0,4,70,0.942857142857143,0.0571428571428571,0,0.0571428571428571
"1384",2018,"Neftenbach","I222",49,6,0,6,55,0.890909090909091,0.109090909090909,0,0.109090909090909
"1385",2019,"Neftenbach","I222",63,4,0,4,67,0.940298507462687,0.0597014925373134,0,0.0597014925373134
"1386",2020,"Neftenbach","I222",43,6,0,6,49,0.877551020408163,0.122448979591837,0,0.122448979591837
"1387",2021,"Neftenbach","I222",60,5,0,5,65,0.923076923076923,0.0769230769230769,0,0.0769230769230769
"1388",2022,"Neftenbach","I222",57,9,0,9,66,0.863636363636364,0.136363636363636,0,0.136363636363636
"1390",2010,"Pfungen","I232",26,2,0,2,28,0.928571428571429,0.0714285714285714,0,0.0714285714285714
"1391",2011,"Pfungen","I232",44,0,1,1,45,0.977777777777778,0,0.0222222222222222,0.0222222222222222
"1392",2012,"Pfungen","I232",29,0,1,1,30,0.966666666666667,0,0.0333333333333333,0.0333333333333333
"1393",2013,"Pfungen","I232",34,1,1,2,36,0.944444444444444,0.0277777777777778,0.0277777777777778,0.0555555555555556
"1394",2014,"Pfungen","I232",35,4,0,4,39,0.897435897435897,0.102564102564103,0,0.102564102564103
"1395",2015,"Pfungen","I232",52,2,3,5,57,0.912280701754386,0.0350877192982456,0.0526315789473684,0.087719298245614
"1396",2016,"Pfungen","I232",39,2,1,3,42,0.928571428571429,0.0476190476190476,0.0238095238095238,0.0714285714285714
"1397",2017,"Pfungen","I232",46,2,0,2,48,0.958333333333333,0.0416666666666667,0,0.0416666666666667
"1398",2018,"Pfungen","I232",50,4,0,4,54,0.925925925925926,0.0740740740740741,0,0.0740740740740741
"1399",2019,"Pfungen","I232",48,3,0,3,51,0.941176470588235,0.0588235294117647,0,0.0588235294117647
"1400",2020,"Pfungen","I232",33,2,0,2,35,0.942857142857143,0.0571428571428571,0,0.0571428571428571
"1401",2021,"Pfungen","I232",33,3,0,3,36,0.916666666666667,0.0833333333333333,0,0.0833333333333333
"1402",2022,"Pfungen","I232",36,1,0,1,37,0.972972972972973,0.027027027027027,0,0.027027027027027
"1404",2010,"Rickenbach","I240",24,1,0,1,25,0.96,0.04,0,0.04
"1405",2011,"Rickenbach","I240",29,1,0,1,30,0.966666666666667,0.0333333333333333,0,0.0333333333333333
"1406",2012,"Rickenbach","I240",26,2,0,2,28,0.928571428571429,0.0714285714285714,0,0.0714285714285714
"1407",2013,"Rickenbach","I240",31,0,1,1,32,0.96875,0,0.03125,0.03125
"1408",2014,"Rickenbach","I240",25,0,0,0,25,1,0,0,0
"1409",2015,"Rickenbach","I240",30,0,0,0,30,1,0,0,0
"1410",2016,"Rickenbach","I240",31,0,1,1,32,0.96875,0,0.03125,0.03125
"1411",2017,"Rickenbach","I240",25,1,1,2,27,0.925925925925926,0.037037037037037,0.037037037037037,0.0740740740740741
"1412",2018,"Rickenbach","I240",31,6,0,6,37,0.837837837837838,0.162162162162162,0,0.162162162162162
"1413",2019,"Rickenbach","I240",37,5,0,5,42,0.880952380952381,0.119047619047619,0,0.119047619047619
"1414",2020,"Rickenbach","I240",40,5,0,5,45,0.888888888888889,0.111111111111111,0,0.111111111111111
"1415",2021,"Rickenbach","I240",37,4,0,4,41,0.902439024390244,0.0975609756097561,0,0.0975609756097561
"1416",2022,"Rickenbach","I240",31,6,0,6,37,0.837837837837838,0.162162162162162,0,0.162162162162162
"1418",2010,"Schlatt","I260",18,0,0,0,18,1,0,0,0
"1419",2011,"Schlatt","I260",8,0,2,2,10,0.8,0,0.2,0.2
"1420",2012,"Schlatt","I260",13,0,0,0,13,1,0,0,0
"1421",2013,"Schlatt","I260",13,0,2,2,15,0.866666666666667,0,0.133333333333333,0.133333333333333
"1422",2014,"Schlatt","I260",8,1,0,1,9,0.888888888888889,0.111111111111111,0,0.111111111111111
"1423",2015,"Schlatt","I260",7,0,0,0,7,1,0,0,0
"1424",2016,"Schlatt","I260",13,0,0,0,13,1,0,0,0
"1425",2017,"Schlatt","I260",9,1,0,1,10,0.9,0.1,0,0.1
"1426",2018,"Schlatt","I260",9,4,0,4,13,0.692307692307692,0.307692307692308,0,0.307692307692308
"1428",2010,"Seuzach","I270",59,2,0,2,61,0.967213114754098,0.0327868852459016,0,0.0327868852459016
"1429",2011,"Seuzach","I270",44,4,0,4,48,0.916666666666667,0.0833333333333333,0,0.0833333333333333
"1430",2012,"Seuzach","I270",49,0,3,3,52,0.942307692307692,0,0.0576923076923077,0.0576923076923077
"1431",2013,"Seuzach","I270",48,2,1,3,51,0.941176470588235,0.0392156862745098,0.0196078431372549,0.0588235294117647
"1432",2014,"Seuzach","I270",67,1,1,2,69,0.971014492753623,0.0144927536231884,0.0144927536231884,0.0289855072463768
"1433",2015,"Seuzach","I270",63,2,1,3,66,0.954545454545455,0.0303030303030303,0.0151515151515152,0.0454545454545455
"1434",2016,"Seuzach","I270",64,0,0,0,64,1,0,0,0
"1435",2017,"Seuzach","I270",62,1,0,1,63,0.984126984126984,0.0158730158730159,0,0.0158730158730159
"1436",2018,"Seuzach","I270",70,2,0,2,72,0.972222222222222,0.0277777777777778,0,0.0277777777777778
"1437",2019,"Seuzach","I270",68,7,0,7,75,0.906666666666667,0.0933333333333333,0,0.0933333333333333
"1438",2020,"Seuzach","I270",79,8,0,8,87,0.908045977011494,0.0919540229885057,0,0.0919540229885057
"1439",2021,"Seuzach","I270",57,7,0,7,64,0.890625,0.109375,0,0.109375
"1440",2022,"Seuzach","I270",69,9,0,9,78,0.884615384615385,0.115384615384615,0,0.115384615384615
"1442",2010,"Turbenthal","I290",36,0,4,4,40,0.9,0,0.1,0.1
"1443",2011,"Turbenthal","I290",35,2,3,5,40,0.875,0.05,0.075,0.125
"1444",2012,"Turbenthal","I290",41,0,3,3,44,0.931818181818182,0,0.0681818181818182,0.0681818181818182
"1445",2013,"Turbenthal","I290",29,0,1,1,30,0.966666666666667,0,0.0333333333333333,0.0333333333333333
"1446",2014,"Turbenthal","I290",49,0,0,0,49,1,0,0,0
"1447",2015,"Turbenthal","I290",50,0,1,1,51,0.980392156862745,0,0.0196078431372549,0.0196078431372549
"1448",2016,"Turbenthal","I290",50,5,0,5,55,0.909090909090909,0.0909090909090909,0,0.0909090909090909
"1449",2017,"Turbenthal","I290",57,3,0,3,60,0.95,0.05,0,0.05
"1450",2018,"Turbenthal","I290",53,4,0,4,57,0.929824561403509,0.0701754385964912,0,0.0701754385964912
"1451",2019,"Turbenthal","I290",57,8,0,8,65,0.876923076923077,0.123076923076923,0,0.123076923076923
"1452",2020,"Turbenthal","I290",58,7,0,7,65,0.892307692307692,0.107692307692308,0,0.107692307692308
"1453",2021,"Turbenthal","I290",50,11,0,11,61,0.819672131147541,0.180327868852459,0,0.180327868852459
"1454",2022,"Turbenthal","I290",36,5,0,5,41,0.878048780487805,0.121951219512195,0,0.121951219512195
"1456",2010,"Wiesendangen","I312",33,1,3,4,37,0.891891891891892,0.027027027027027,0.0810810810810811,0.108108108108108
"1458",2010,"Zell","I322",52,1,1,2,54,0.962962962962963,0.0185185185185185,0.0185185185185185,0.037037037037037
"1459",2011,"Zell","I322",41,1,0,1,42,0.976190476190476,0.0238095238095238,0,0.0238095238095238
"1460",2012,"Zell","I322",60,0,1,1,61,0.983606557377049,0,0.0163934426229508,0.0163934426229508
"1461",2013,"Zell","I322",52,0,2,2,54,0.962962962962963,0,0.037037037037037,0.037037037037037
"1462",2014,"Zell","I322",64,0,0,0,64,1,0,0,0
"1463",2015,"Zell","I322",62,1,0,1,63,0.984126984126984,0.0158730158730159,0,0.0158730158730159
"1464",2016,"Zell","I322",54,1,0,1,55,0.981818181818182,0.0181818181818182,0,0.0181818181818182
"1465",2017,"Zell","I322",62,6,0,6,68,0.911764705882353,0.0882352941176471,0,0.0882352941176471
"1466",2018,"Zell","I322",62,1,1,2,64,0.96875,0.015625,0.015625,0.03125
"1467",2019,"Zell","I322",81,6,0,6,87,0.931034482758621,0.0689655172413793,0,0.0689655172413793
"1468",2020,"Zell","I322",73,4,0,4,77,0.948051948051948,0.051948051948052,0,0.051948051948052
"1469",2021,"Zell","I322",72,10,0,10,82,0.878048780487805,0.121951219512195,0,0.121951219512195
"1470",2022,"Zell","I322",69,3,0,3,72,0.958333333333333,0.0416666666666667,0,0.0416666666666667
"1471",2011,"Wiesendangen","I332",61,1,3,4,65,0.938461538461538,0.0153846153846154,0.0461538461538462,0.0615384615384615
"1472",2012,"Wiesendangen","I332",70,2,2,4,74,0.945945945945946,0.027027027027027,0.027027027027027,0.0540540540540541
"1473",2013,"Wiesendangen","I332",59,1,2,3,62,0.951612903225806,0.0161290322580645,0.032258064516129,0.0483870967741935
"1474",2014,"Wiesendangen","I332",80,4,0,4,84,0.952380952380952,0.0476190476190476,0,0.0476190476190476
"1475",2015,"Wiesendangen","I332",64,5,1,6,70,0.914285714285714,0.0714285714285714,0.0142857142857143,0.0857142857142857
"1476",2016,"Wiesendangen","I332",71,4,0,4,75,0.946666666666667,0.0533333333333333,0,0.0533333333333333
"1477",2017,"Wiesendangen","I332",59,7,0,7,66,0.893939393939394,0.106060606060606,0,0.106060606060606
"1478",2018,"Wiesendangen","I332",61,5,1,6,67,0.91044776119403,0.0746268656716418,0.0149253731343284,0.0895522388059701
"1479",2019,"Wiesendangen","I332",62,6,0,6,68,0.911764705882353,0.0882352941176471,0,0.0882352941176471
"1480",2020,"Wiesendangen","I332",51,13,0,13,64,0.796875,0.203125,0,0.203125
"1481",2021,"Wiesendangen","I332",66,12,0,12,78,0.846153846153846,0.153846153846154,0,0.153846153846154
"1482",2022,"Wiesendangen","I332",52,6,0,6,58,0.896551724137931,0.103448275862069,0,0.103448275862069
"1483",2019,"Elsau-Schlatt","I343",47,7,0,7,54,0.87037037037037,0.12962962962963,0,0.12962962962963
"1484",2020,"Elsau-Schlatt","I343",45,8,0,8,53,0.849056603773585,0.150943396226415,0,0.150943396226415
"1485",2021,"Elsau-Schlatt","I343",34,5,0,5,39,0.871794871794872,0.128205128205128,0,0.128205128205128
"1486",2022,"Elsau-Schlatt","I343",52,10,0,10,62,0.838709677419355,0.161290322580645,0,0.161290322580645
"1487",2015,"Winterthur","J001",1,0,0,0,1,1,0,0,0
"1488",2016,"Winterthur","J001",1,0,0,0,1,1,0,0,0
"1489",2014,"Winterthur Stadt-Töss","J012",279,2,6,8,287,0.97212543554007,0.00696864111498258,0.0209059233449477,0.0278745644599303
"1490",2015,"Winterthur Stadt-Töss","J012",252,6,4,10,262,0.961832061068702,0.0229007633587786,0.0152671755725191,0.0381679389312977
"1491",2016,"Winterthur Stadt-Töss","J012",247,9,3,12,259,0.953667953667954,0.0347490347490347,0.0115830115830116,0.0463320463320463
"1492",2017,"Winterthur Stadt-Töss","J012",269,12,1,13,282,0.953900709219858,0.0425531914893617,0.00354609929078014,0.0460992907801418
"1493",2018,"Winterthur Stadt-Töss","J012",260,18,4,22,282,0.921985815602837,0.0638297872340425,0.0141843971631206,0.0780141843971631
"1494",2019,"Winterthur Stadt-Töss","J012",244,15,0,15,259,0.942084942084942,0.0579150579150579,0,0.0579150579150579
"1495",2020,"Winterthur Stadt-Töss","J012",226,17,0,17,243,0.930041152263374,0.0699588477366255,0,0.0699588477366255
"1496",2021,"Winterthur Stadt-Töss","J012",269,22,0,22,291,0.924398625429553,0.0756013745704467,0,0.0756013745704467
"1497",2022,"Winterthur Stadt-Töss","J012",252,18,0,18,270,0.933333333333333,0.0666666666666667,0,0.0666666666666667
"1498",2014,"Winterthur-Oberwinterthur","J022",248,6,1,7,255,0.972549019607843,0.0235294117647059,0.00392156862745098,0.0274509803921569
"1499",2015,"Winterthur-Oberwinterthur","J022",268,8,0,8,276,0.971014492753623,0.0289855072463768,0,0.0289855072463768
"1500",2016,"Winterthur-Oberwinterthur","J022",250,8,2,10,260,0.961538461538462,0.0307692307692308,0.00769230769230769,0.0384615384615385
"1501",2017,"Winterthur-Oberwinterthur","J022",258,13,0,13,271,0.952029520295203,0.0479704797047971,0,0.0479704797047971
"1502",2018,"Winterthur-Oberwinterthur","J022",268,24,1,25,293,0.914675767918089,0.0819112627986348,0.00341296928327645,0.0853242320819113
"1503",2019,"Winterthur-Oberwinterthur","J022",264,24,0,24,288,0.916666666666667,0.0833333333333333,0,0.0833333333333333
"1504",2020,"Winterthur-Oberwinterthur","J022",263,28,0,28,291,0.903780068728522,0.0962199312714777,0,0.0962199312714777
"1505",2021,"Winterthur-Oberwinterthur","J022",264,30,0,30,294,0.897959183673469,0.102040816326531,0,0.102040816326531
"1506",2022,"Winterthur-Oberwinterthur","J022",307,29,0,29,336,0.913690476190476,0.0863095238095238,0,0.0863095238095238
"1507",2014,"Winterthur Seen-Mattenbach","J032",300,4,4,8,308,0.974025974025974,0.012987012987013,0.012987012987013,0.025974025974026
"1508",2015,"Winterthur Seen-Mattenbach","J032",291,11,4,15,306,0.950980392156863,0.0359477124183007,0.0130718954248366,0.0490196078431373
"1509",2016,"Winterthur Seen-Mattenbach","J032",308,11,1,12,320,0.9625,0.034375,0.003125,0.0375
"1510",2017,"Winterthur Seen-Mattenbach","J032",312,16,6,22,334,0.934131736526946,0.0479041916167665,0.0179640718562874,0.0658682634730539
"1511",2018,"Winterthur Seen-Mattenbach","J032",312,20,0,20,332,0.939759036144578,0.0602409638554217,0,0.0602409638554217
"1512",2019,"Winterthur Seen-Mattenbach","J032",296,26,0,26,322,0.919254658385093,0.0807453416149068,0,0.0807453416149068
"1513",2020,"Winterthur Seen-Mattenbach","J032",323,51,0,51,374,0.863636363636364,0.136363636363636,0,0.136363636363636
"1514",2021,"Winterthur Seen-Mattenbach","J032",299,34,0,34,333,0.897897897897898,0.102102102102102,0,0.102102102102102
"1515",2022,"Winterthur Seen-Mattenbach","J032",344,35,0,35,379,0.907651715039578,0.0923482849604222,0,0.0923482849604222
"1516",2014,"Winterthur Veltheim-Wülflingen","J042",251,4,2,6,257,0.976653696498054,0.0155642023346304,0.00778210116731518,0.0233463035019455
"1517",2015,"Winterthur Veltheim-Wülflingen","J042",243,7,0,7,250,0.972,0.028,0,0.028
"1518",2016,"Winterthur Veltheim-Wülflingen","J042",271,10,0,10,281,0.9644128113879,0.0355871886120996,0,0.0355871886120996
"1519",2017,"Winterthur Veltheim-Wülflingen","J042",252,10,3,13,265,0.950943396226415,0.0377358490566038,0.0113207547169811,0.0490566037735849
"1520",2018,"Winterthur Veltheim-Wülflingen","J042",253,16,0,16,269,0.940520446096654,0.0594795539033457,0,0.0594795539033457
"1521",2019,"Winterthur Veltheim-Wülflingen","J042",239,17,0,17,256,0.93359375,0.06640625,0,0.06640625
"1522",2020,"Winterthur Veltheim-Wülflingen","J042",247,22,0,22,269,0.9182156133829,0.0817843866171004,0,0.0817843866171004
"1523",2021,"Winterthur Veltheim-Wülflingen","J042",259,32,0,32,291,0.890034364261168,0.109965635738832,0,0.109965635738832
"1524",2022,"Winterthur Veltheim-Wülflingen","J042",215,18,0,18,233,0.92274678111588,0.0772532188841202,0,0.0772532188841202
"1525",2011,"Adlikon","K010",2,0,0,0,2,1,0,0,0
"1526",2012,"Adlikon","K010",1,0,0,0,1,1,0,0,0
"1527",2014,"Adlikon","K010",1,0,0,0,1,1,0,0,0
"1528",2015,"Adlikon","K010",3,0,0,0,3,1,0,0,0
"1529",2016,"Adlikon","K010",8,0,0,0,8,1,0,0,0
"1530",2017,"Adlikon","K010",5,0,0,0,5,1,0,0,0
"1531",2018,"Adlikon","K010",6,3,0,3,9,0.666666666666667,0.333333333333333,0,0.333333333333333
"1532",2019,"Adlikon","K010",5,3,0,3,8,0.625,0.375,0,0.375
"1533",2020,"Adlikon","K010",6,2,0,2,8,0.75,0.25,0,0.25
"1534",2021,"Adlikon","K010",6,0,0,0,6,1,0,0,0
"1535",2022,"Adlikon","K010",6,2,0,2,8,0.75,0.25,0,0.25
"1537",2010,"Andelfingen","K020",51,2,1,3,54,0.944444444444444,0.037037037037037,0.0185185185185185,0.0555555555555556
"1538",2011,"Andelfingen","K020",47,0,1,1,48,0.979166666666667,0,0.0208333333333333,0.0208333333333333
"1539",2012,"Andelfingen","K020",52,2,1,3,55,0.945454545454545,0.0363636363636364,0.0181818181818182,0.0545454545454545
"1540",2013,"Andelfingen","K020",60,0,0,0,60,1,0,0,0
"1541",2014,"Andelfingen","K020",48,2,0,2,50,0.96,0.04,0,0.04
"1542",2015,"Andelfingen","K020",64,1,0,1,65,0.984615384615385,0.0153846153846154,0,0.0153846153846154
"1543",2016,"Andelfingen","K020",52,3,1,4,56,0.928571428571429,0.0535714285714286,0.0178571428571429,0.0714285714285714
"1544",2017,"Andelfingen","K020",59,1,0,1,60,0.983333333333333,0.0166666666666667,0,0.0166666666666667
"1545",2018,"Andelfingen","K020",48,5,0,5,53,0.905660377358491,0.0943396226415094,0,0.0943396226415094
"1546",2019,"Andelfingen","K020",48,0,0,0,48,1,0,0,0
"1547",2020,"Andelfingen","K020",50,6,0,6,56,0.892857142857143,0.107142857142857,0,0.107142857142857
"1548",2021,"Andelfingen","K020",39,6,0,6,45,0.866666666666667,0.133333333333333,0,0.133333333333333
"1549",2022,"Andelfingen","K020",40,3,0,3,43,0.930232558139535,0.0697674418604651,0,0.0697674418604651
"1551",2010,"Benken","K040",8,0,0,0,8,1,0,0,0
"1552",2011,"Benken","K040",5,0,0,0,5,1,0,0,0
"1553",2012,"Benken","K040",8,0,0,0,8,1,0,0,0
"1554",2013,"Benken","K040",8,0,1,1,9,0.888888888888889,0,0.111111111111111,0.111111111111111
"1555",2014,"Benken","K040",3,0,0,0,3,1,0,0,0
"1556",2015,"Benken","K040",7,1,0,1,8,0.875,0.125,0,0.125
"1557",2016,"Benken","K040",7,0,0,0,7,1,0,0,0
"1558",2017,"Benken","K040",8,1,0,1,9,0.888888888888889,0.111111111111111,0,0.111111111111111
"1559",2018,"Benken","K040",11,1,0,1,12,0.916666666666667,0.0833333333333333,0,0.0833333333333333
"1560",2019,"Benken","K040",8,1,0,1,9,0.888888888888889,0.111111111111111,0,0.111111111111111
"1561",2020,"Benken","K040",11,2,0,2,13,0.846153846153846,0.153846153846154,0,0.153846153846154
"1562",2021,"Benken","K040",12,2,0,2,14,0.857142857142857,0.142857142857143,0,0.142857142857143
"1563",2022,"Benken","K040",2,0,0,0,2,1,0,0,0
"1565",2010,"Berg a.I.","K050",6,0,0,0,6,1,0,0,0
"1566",2011,"Berg a.I.","K050",4,0,0,0,4,1,0,0,0
"1567",2012,"Berg a.I.","K050",5,0,0,0,5,1,0,0,0
"1568",2013,"Berg a.I.","K050",3,0,0,0,3,1,0,0,0
"1569",2014,"Berg a.I.","K050",3,0,1,1,4,0.75,0,0.25,0.25
"1571",2010,"Buch a.I.","K060",10,0,0,0,10,1,0,0,0
"1572",2011,"Buch a.I.","K060",9,1,0,1,10,0.9,0.1,0,0.1
"1573",2012,"Buch a.I.","K060",14,1,0,1,15,0.933333333333333,0.0666666666666667,0,0.0666666666666667
"1574",2013,"Buch a.I.","K060",9,1,0,1,10,0.9,0.1,0,0.1
"1575",2014,"Buch a.I.","K060",15,1,1,2,17,0.882352941176471,0.0588235294117647,0.0588235294117647,0.117647058823529
"1577",2010,"Dachsen","K070",18,0,3,3,21,0.857142857142857,0,0.142857142857143,0.142857142857143
"1578",2011,"Dachsen","K070",18,0,1,1,19,0.947368421052632,0,0.0526315789473684,0.0526315789473684
"1579",2012,"Dachsen","K070",24,0,2,2,26,0.923076923076923,0,0.0769230769230769,0.0769230769230769
"1580",2013,"Dachsen","K070",23,1,1,2,25,0.92,0.04,0.04,0.08
"1581",2014,"Dachsen","K070",17,0,0,0,17,1,0,0,0
"1582",2015,"Dachsen","K070",22,2,0,2,24,0.916666666666667,0.0833333333333333,0,0.0833333333333333
"1583",2016,"Dachsen","K070",9,3,1,4,13,0.692307692307692,0.230769230769231,0.0769230769230769,0.307692307692308
"1584",2017,"Dachsen","K070",18,1,0,1,19,0.947368421052632,0.0526315789473684,0,0.0526315789473684
"1585",2018,"Dachsen","K070",20,0,0,0,20,1,0,0,0
"1586",2019,"Dachsen","K070",17,4,0,4,21,0.80952380952381,0.19047619047619,0,0.19047619047619
"1587",2020,"Dachsen","K070",14,3,0,3,17,0.823529411764706,0.176470588235294,0,0.176470588235294
"1588",2021,"Dachsen","K070",11,3,0,3,14,0.785714285714286,0.214285714285714,0,0.214285714285714
"1589",2022,"Dachsen","K070",16,3,0,3,19,0.842105263157895,0.157894736842105,0,0.157894736842105
"1591",2010,"Dorf","K080",7,1,0,1,8,0.875,0.125,0,0.125
"1592",2011,"Dorf","K080",6,0,0,0,6,1,0,0,0
"1593",2012,"Dorf","K080",4,1,1,2,6,0.666666666666667,0.166666666666667,0.166666666666667,0.333333333333333
"1594",2013,"Dorf","K080",5,0,1,1,6,0.833333333333333,0,0.166666666666667,0.166666666666667
"1595",2014,"Dorf","K080",2,0,0,0,2,1,0,0,0
"1597",2010,"Feuerthalen","K092",38,0,0,0,38,1,0,0,0
"1598",2011,"Feuerthalen","K092",19,1,1,2,21,0.904761904761905,0.0476190476190476,0.0476190476190476,0.0952380952380952
"1599",2012,"Feuerthalen","K092",28,1,1,2,30,0.933333333333333,0.0333333333333333,0.0333333333333333,0.0666666666666667
"1600",2013,"Feuerthalen","K092",40,0,0,0,40,1,0,0,0
"1601",2014,"Feuerthalen","K092",34,0,0,0,34,1,0,0,0
"1602",2015,"Feuerthalen","K092",32,3,1,4,36,0.888888888888889,0.0833333333333333,0.0277777777777778,0.111111111111111
"1603",2016,"Feuerthalen","K092",33,0,1,1,34,0.970588235294118,0,0.0294117647058824,0.0294117647058824
"1604",2017,"Feuerthalen","K092",49,2,0,2,51,0.96078431372549,0.0392156862745098,0,0.0392156862745098
"1605",2018,"Feuerthalen","K092",30,2,0,2,32,0.9375,0.0625,0,0.0625
"1606",2019,"Feuerthalen","K092",41,5,0,5,46,0.891304347826087,0.108695652173913,0,0.108695652173913
"1607",2020,"Feuerthalen","K092",40,5,0,5,45,0.888888888888889,0.111111111111111,0,0.111111111111111
"1608",2021,"Feuerthalen","K092",34,3,0,3,37,0.918918918918919,0.0810810810810811,0,0.0810810810810811
"1609",2022,"Feuerthalen","K092",37,1,0,1,38,0.973684210526316,0.0263157894736842,0,0.0263157894736842
"1611",2010,"Flaach","K100",14,0,1,1,15,0.933333333333333,0,0.0666666666666667,0.0666666666666667
"1612",2011,"Flaach","K100",14,0,0,0,14,1,0,0,0
"1613",2012,"Flaach","K100",7,1,0,1,8,0.875,0.125,0,0.125
"1614",2013,"Flaach","K100",9,0,0,0,9,1,0,0,0
"1615",2014,"Flaach","K100",11,0,1,1,12,0.916666666666667,0,0.0833333333333333,0.0833333333333333
"1617",2010,"Flurlingen","K120",14,0,0,0,14,1,0,0,0
"1618",2011,"Flurlingen","K120",17,0,0,0,17,1,0,0,0
"1619",2012,"Flurlingen","K120",14,0,0,0,14,1,0,0,0
"1620",2013,"Flurlingen","K120",17,0,0,0,17,1,0,0,0
"1621",2014,"Flurlingen","K120",13,0,0,0,13,1,0,0,0
"1622",2015,"Flurlingen","K120",4,1,1,2,6,0.666666666666667,0.166666666666667,0.166666666666667,0.333333333333333
"1623",2016,"Flurlingen","K120",17,0,0,0,17,1,0,0,0
"1624",2017,"Flurlingen","K120",7,0,0,0,7,1,0,0,0
"1625",2018,"Flurlingen","K120",13,1,0,1,14,0.928571428571429,0.0714285714285714,0,0.0714285714285714
"1626",2019,"Flurlingen","K120",13,3,0,3,16,0.8125,0.1875,0,0.1875
"1627",2020,"Flurlingen","K120",14,1,0,1,15,0.933333333333333,0.0666666666666667,0,0.0666666666666667
"1628",2021,"Flurlingen","K120",19,2,0,2,21,0.904761904761905,0.0952380952380952,0,0.0952380952380952
"1629",2022,"Flurlingen","K120",11,1,0,1,12,0.916666666666667,0.0833333333333333,0,0.0833333333333333
"1631",2010,"Henggart","K130",28,0,2,2,30,0.933333333333333,0,0.0666666666666667,0.0666666666666667
"1632",2011,"Henggart","K130",26,0,1,1,27,0.962962962962963,0,0.037037037037037,0.037037037037037
"1633",2012,"Henggart","K130",23,0,4,4,27,0.851851851851852,0,0.148148148148148,0.148148148148148
"1634",2013,"Henggart","K130",23,0,0,0,23,1,0,0,0
"1635",2014,"Henggart","K130",33,0,1,1,34,0.970588235294118,0,0.0294117647058824,0.0294117647058824
"1636",2015,"Henggart","K130",27,0,1,1,28,0.964285714285714,0,0.0357142857142857,0.0357142857142857
"1637",2016,"Henggart","K130",26,1,1,2,28,0.928571428571429,0.0357142857142857,0.0357142857142857,0.0714285714285714
"1638",2017,"Henggart","K130",23,3,0,3,26,0.884615384615385,0.115384615384615,0,0.115384615384615
"1639",2018,"Henggart","K130",19,4,0,4,23,0.826086956521739,0.173913043478261,0,0.173913043478261
"1640",2019,"Henggart","K130",22,0,0,0,22,1,0,0,0
"1641",2020,"Henggart","K130",25,4,0,4,29,0.862068965517241,0.137931034482759,0,0.137931034482759
"1642",2021,"Henggart","K130",17,1,0,1,18,0.944444444444444,0.0555555555555556,0,0.0555555555555556
"1643",2022,"Henggart","K130",12,4,0,4,16,0.75,0.25,0,0.25
"1645",2010,"Humlikon","K140",2,0,0,0,2,1,0,0,0
"1646",2011,"Humlikon","K140",7,0,0,0,7,1,0,0,0
"1647",2012,"Humlikon","K140",9,0,1,1,10,0.9,0,0.1,0.1
"1648",2013,"Humlikon","K140",3,1,1,2,5,0.6,0.2,0.2,0.4
"1649",2014,"Humlikon","K140",9,0,0,0,9,1,0,0,0
"1650",2015,"Humlikon","K140",6,1,0,1,7,0.857142857142857,0.142857142857143,0,0.142857142857143
"1651",2016,"Humlikon","K140",7,2,0,2,9,0.777777777777778,0.222222222222222,0,0.222222222222222
"1652",2017,"Humlikon","K140",6,0,0,0,6,1,0,0,0
"1653",2018,"Humlikon","K140",4,0,0,0,4,1,0,0,0
"1654",2019,"Humlikon","K140",7,2,0,2,9,0.777777777777778,0.222222222222222,0,0.222222222222222
"1655",2020,"Humlikon","K140",1,1,0,1,2,0.5,0.5,0,0.5
"1656",2021,"Humlikon","K140",2,1,0,1,3,0.666666666666667,0.333333333333333,0,0.333333333333333
"1657",2022,"Humlikon","K140",5,3,0,3,8,0.625,0.375,0,0.375
"1659",2010,"Laufen-Uhwiesen","K160",10,0,0,0,10,1,0,0,0
"1660",2011,"Laufen-Uhwiesen","K160",22,1,0,1,23,0.956521739130435,0.0434782608695652,0,0.0434782608695652
"1661",2012,"Laufen-Uhwiesen","K160",9,0,0,0,9,1,0,0,0
"1662",2013,"Laufen-Uhwiesen","K160",15,2,1,3,18,0.833333333333333,0.111111111111111,0.0555555555555556,0.166666666666667
"1663",2014,"Laufen-Uhwiesen","K160",16,1,1,2,18,0.888888888888889,0.0555555555555556,0.0555555555555556,0.111111111111111
"1664",2015,"Laufen-Uhwiesen","K160",13,2,0,2,15,0.866666666666667,0.133333333333333,0,0.133333333333333
"1665",2016,"Laufen-Uhwiesen","K160",14,2,0,2,16,0.875,0.125,0,0.125
"1666",2017,"Laufen-Uhwiesen","K160",14,1,0,1,15,0.933333333333333,0.0666666666666667,0,0.0666666666666667
"1667",2018,"Laufen-Uhwiesen","K160",14,2,0,2,16,0.875,0.125,0,0.125
"1668",2019,"Laufen-Uhwiesen","K160",8,4,0,4,12,0.666666666666667,0.333333333333333,0,0.333333333333333
"1669",2020,"Laufen-Uhwiesen","K160",9,2,0,2,11,0.818181818181818,0.181818181818182,0,0.181818181818182
"1670",2021,"Laufen-Uhwiesen","K160",12,2,0,2,14,0.857142857142857,0.142857142857143,0,0.142857142857143
"1671",2022,"Laufen-Uhwiesen","K160",13,3,0,3,16,0.8125,0.1875,0,0.1875
"1673",2010,"Marthalen","K180",14,0,1,1,15,0.933333333333333,0,0.0666666666666667,0.0666666666666667
"1674",2011,"Marthalen","K180",24,1,1,2,26,0.923076923076923,0.0384615384615385,0.0384615384615385,0.0769230769230769
"1675",2012,"Marthalen","K180",18,0,0,0,18,1,0,0,0
"1676",2013,"Marthalen","K180",17,0,0,0,17,1,0,0,0
"1677",2014,"Marthalen","K180",24,0,0,0,24,1,0,0,0
"1678",2015,"Marthalen","K180",20,0,0,0,20,1,0,0,0
"1679",2016,"Marthalen","K180",17,2,0,2,19,0.894736842105263,0.105263157894737,0,0.105263157894737
"1680",2017,"Marthalen","K180",18,3,0,3,21,0.857142857142857,0.142857142857143,0,0.142857142857143
"1681",2018,"Marthalen","K180",15,0,0,0,15,1,0,0,0
"1682",2019,"Marthalen","K180",23,1,0,1,24,0.958333333333333,0.0416666666666667,0,0.0416666666666667
"1683",2020,"Marthalen","K180",16,2,0,2,18,0.888888888888889,0.111111111111111,0,0.111111111111111
"1684",2021,"Marthalen","K180",16,3,0,3,19,0.842105263157895,0.157894736842105,0,0.157894736842105
"1685",2022,"Marthalen","K180",13,5,0,5,18,0.722222222222222,0.277777777777778,0,0.277777777777778
"1687",2010,"Ossingen","K210",12,1,1,2,14,0.857142857142857,0.0714285714285714,0.0714285714285714,0.142857142857143
"1688",2011,"Ossingen","K210",14,1,0,1,15,0.933333333333333,0.0666666666666667,0,0.0666666666666667
"1689",2012,"Ossingen","K210",12,0,0,0,12,1,0,0,0
"1690",2013,"Ossingen","K210",9,0,0,0,9,1,0,0,0
"1691",2014,"Ossingen","K210",17,0,0,0,17,1,0,0,0
"1692",2015,"Ossingen","K210",10,1,0,1,11,0.909090909090909,0.0909090909090909,0,0.0909090909090909
"1693",2016,"Ossingen","K210",13,1,0,1,14,0.928571428571429,0.0714285714285714,0,0.0714285714285714
"1694",2017,"Ossingen","K210",11,0,0,0,11,1,0,0,0
"1695",2018,"Ossingen","K210",21,0,0,0,21,1,0,0,0
"1696",2019,"Ossingen","K210",10,2,0,2,12,0.833333333333333,0.166666666666667,0,0.166666666666667
"1697",2020,"Ossingen","K210",28,2,0,2,30,0.933333333333333,0.0666666666666667,0,0.0666666666666667
"1698",2021,"Ossingen","K210",21,1,0,1,22,0.954545454545455,0.0454545454545455,0,0.0454545454545455
"1699",2022,"Ossingen","K210",23,4,0,4,27,0.851851851851852,0.148148148148148,0,0.148148148148148
"1701",2010,"Rheinau","K230",13,0,0,0,13,1,0,0,0
"1702",2011,"Rheinau","K230",13,0,0,0,13,1,0,0,0
"1703",2012,"Rheinau","K230",11,1,0,1,12,0.916666666666667,0.0833333333333333,0,0.0833333333333333
"1704",2013,"Rheinau","K230",11,0,0,0,11,1,0,0,0
"1705",2014,"Rheinau","K230",9,0,0,0,9,1,0,0,0
"1706",2015,"Rheinau","K230",14,0,0,0,14,1,0,0,0
"1707",2016,"Rheinau","K230",14,0,0,0,14,1,0,0,0
"1708",2017,"Rheinau","K230",11,0,0,0,11,1,0,0,0
"1709",2018,"Rheinau","K230",11,0,0,0,11,1,0,0,0
"1710",2019,"Rheinau","K230",13,0,0,0,13,1,0,0,0
"1711",2020,"Rheinau","K230",11,0,0,0,11,1,0,0,0
"1712",2021,"Rheinau","K230",7,1,0,1,8,0.875,0.125,0,0.125
"1713",2022,"Rheinau","K230",9,4,0,4,13,0.692307692307692,0.307692307692308,0,0.307692307692308
"1715",2010,"Stammertal","K242",23,3,0,3,26,0.884615384615385,0.115384615384615,0,0.115384615384615
"1716",2011,"Stammertal","K242",27,1,0,1,28,0.964285714285714,0.0357142857142857,0,0.0357142857142857
"1717",2012,"Stammertal","K242",32,2,0,2,34,0.941176470588235,0.0588235294117647,0,0.0588235294117647
"1718",2013,"Stammertal","K242",25,1,0,1,26,0.961538461538462,0.0384615384615385,0,0.0384615384615385
"1719",2014,"Stammertal","K242",24,4,1,5,29,0.827586206896552,0.137931034482759,0.0344827586206897,0.172413793103448
"1720",2015,"Stammertal","K242",27,2,0,2,29,0.931034482758621,0.0689655172413793,0,0.0689655172413793
"1721",2016,"Stammertal","K242",29,4,0,4,33,0.878787878787879,0.121212121212121,0,0.121212121212121
"1722",2017,"Stammertal","K242",28,3,0,3,31,0.903225806451613,0.0967741935483871,0,0.0967741935483871
"1723",2018,"Stammertal","K242",27,2,0,2,29,0.931034482758621,0.0689655172413793,0,0.0689655172413793
"1724",2019,"Stammheim","K242",19,3,0,3,22,0.863636363636364,0.136363636363636,0,0.136363636363636
"1725",2020,"Stammheim","K242",19,10,0,10,29,0.655172413793103,0.344827586206897,0,0.344827586206897
"1726",2021,"Stammheim","K242",30,7,0,7,37,0.810810810810811,0.189189189189189,0,0.189189189189189
"1727",2022,"Stammheim","K242",22,5,0,5,27,0.814814814814815,0.185185185185185,0,0.185185185185185
"1729",2010,"Thalheim an der Thur","K250",14,2,0,2,16,0.875,0.125,0,0.125
"1730",2011,"Thalheim an der Thur","K250",10,0,0,0,10,1,0,0,0
"1731",2012,"Thalheim an der Thur","K250",9,0,0,0,9,1,0,0,0
"1732",2013,"Thalheim an der Thur","K250",8,1,0,1,9,0.888888888888889,0.111111111111111,0,0.111111111111111
"1733",2014,"Thalheim an der Thur","K250",9,0,0,0,9,1,0,0,0
"1734",2015,"Thalheim an der Thur","K250",10,0,0,0,10,1,0,0,0
"1735",2016,"Thalheim an der Thur","K250",7,0,0,0,7,1,0,0,0
"1736",2017,"Thalheim an der Thur","K250",11,0,0,0,11,1,0,0,0
"1737",2018,"Thalheim an der Thur","K250",4,0,0,0,4,1,0,0,0
"1738",2019,"Thalheim an der Thur","K250",7,1,0,1,8,0.875,0.125,0,0.125
"1739",2020,"Thalheim an der Thur","K250",5,0,0,0,5,1,0,0,0
"1740",2021,"Thalheim an der Thur","K250",12,0,0,0,12,1,0,0,0
"1741",2022,"Thalheim an der Thur","K250",6,1,0,1,7,0.857142857142857,0.142857142857143,0,0.142857142857143
"1743",2010,"Trüllikon","K260",12,1,0,1,13,0.923076923076923,0.0769230769230769,0,0.0769230769230769
"1744",2011,"Trüllikon","K260",12,0,0,0,12,1,0,0,0
"1745",2012,"Trüllikon","K260",7,0,0,0,7,1,0,0,0
"1746",2013,"Trüllikon","K260",13,0,0,0,13,1,0,0,0
"1747",2014,"Trüllikon","K260",12,0,1,1,13,0.923076923076923,0,0.0769230769230769,0.0769230769230769
"1748",2015,"Trüllikon","K260",5,1,0,1,6,0.833333333333333,0.166666666666667,0,0.166666666666667
"1749",2016,"Trüllikon","K260",10,1,0,1,11,0.909090909090909,0.0909090909090909,0,0.0909090909090909
"1750",2017,"Trüllikon","K260",8,0,0,0,8,1,0,0,0
"1751",2018,"Trüllikon","K260",12,2,0,2,14,0.857142857142857,0.142857142857143,0,0.142857142857143
"1752",2019,"Trüllikon","K260",5,0,0,0,5,1,0,0,0
"1753",2020,"Trüllikon","K260",5,0,0,0,5,1,0,0,0
"1754",2021,"Trüllikon","K260",10,1,0,1,11,0.909090909090909,0.0909090909090909,0,0.0909090909090909
"1755",2022,"Trüllikon","K260",4,5,0,5,9,0.444444444444444,0.555555555555556,0,0.555555555555556
"1756",2010,"Truttikon","K270",4,0,0,0,4,1,0,0,0
"1757",2011,"Truttikon","K270",6,0,0,0,6,1,0,0,0
"1758",2012,"Truttikon","K270",6,0,0,0,6,1,0,0,0
"1759",2013,"Truttikon","K270",5,0,0,0,5,1,0,0,0
"1760",2014,"Truttikon","K270",3,0,0,0,3,1,0,0,0
"1761",2015,"Truttikon","K270",3,0,0,0,3,1,0,0,0
"1762",2016,"Truttikon","K270",5,0,0,0,5,1,0,0,0
"1763",2017,"Truttikon","K270",4,1,0,1,5,0.8,0.2,0,0.2
"1764",2018,"Truttikon","K270",5,0,0,0,5,1,0,0,0
"1765",2019,"Truttikon","K270",5,1,0,1,6,0.833333333333333,0.166666666666667,0,0.166666666666667
"1766",2020,"Truttikon","K270",3,2,0,2,5,0.6,0.4,0,0.4
"1767",2021,"Truttikon","K270",5,2,0,2,7,0.714285714285714,0.285714285714286,0,0.285714285714286
"1768",2022,"Truttikon","K270",3,0,0,0,3,1,0,0,0
"1769",2010,"Volken","K290",4,0,0,0,4,1,0,0,0
"1770",2011,"Volken","K290",9,0,1,1,10,0.9,0,0.1,0.1
"1771",2012,"Volken","K290",2,0,0,0,2,1,0,0,0
"1772",2013,"Volken","K290",6,0,0,0,6,1,0,0,0
"1773",2014,"Volken","K290",5,0,0,0,5,1,0,0,0
"1774",2015,"Flaachtal","K302",35,1,0,1,36,0.972222222222222,0.0277777777777778,0,0.0277777777777778
"1775",2016,"Flaachtal","K302",44,1,2,3,47,0.936170212765957,0.0212765957446809,0.0425531914893617,0.0638297872340425
"1776",2017,"Flaachtal","K302",40,3,0,3,43,0.930232558139535,0.0697674418604651,0,0.0697674418604651
"1777",2018,"Flaachtal","K302",35,5,1,6,41,0.853658536585366,0.121951219512195,0.024390243902439,0.146341463414634
"1778",2019,"Flaachtal","K302",48,3,0,3,51,0.941176470588235,0.0588235294117647,0,0.0588235294117647
"1779",2020,"Flaachtal","K302",41,0,0,0,41,1,0,0,0
"1780",2021,"Flaachtal","K302",35,2,0,2,37,0.945945945945946,0.0540540540540541,0,0.0540540540540541
"1781",2022,"Flaachtal","K302",53,8,0,8,61,0.868852459016393,0.131147540983607,0,0.131147540983607
"1783",2010,"Bachenbülach","L010",45,0,0,0,45,1,0,0,0
"1784",2011,"Bachenbülach","L010",40,2,1,3,43,0.930232558139535,0.0465116279069767,0.0232558139534884,0.0697674418604651
"1785",2012,"Bachenbülach","L010",44,0,0,0,44,1,0,0,0
"1786",2013,"Bachenbülach","L010",41,0,1,1,42,0.976190476190476,0,0.0238095238095238,0.0238095238095238
"1787",2014,"Bachenbülach","L010",43,1,0,1,44,0.977272727272727,0.0227272727272727,0,0.0227272727272727
"1788",2015,"Bachenbülach","L010",42,2,0,2,44,0.954545454545455,0.0454545454545455,0,0.0454545454545455
"1789",2016,"Bachenbülach","L010",45,2,0,2,47,0.957446808510638,0.0425531914893617,0,0.0425531914893617
"1790",2017,"Bachenbülach","L010",36,0,0,0,36,1,0,0,0
"1791",2018,"Bachenbülach","L010",49,0,0,0,49,1,0,0,0
"1792",2019,"Bachenbülach","L010",38,1,0,1,39,0.974358974358974,0.0256410256410256,0,0.0256410256410256
"1793",2020,"Bachenbülach","L010",38,0,0,0,38,1,0,0,0
"1794",2021,"Bachenbülach","L010",38,2,0,2,40,0.95,0.05,0,0.05
"1795",2022,"Bachenbülach","L010",38,1,0,1,39,0.974358974358974,0.0256410256410256,0,0.0256410256410256
"1797",2010,"Bassersdorf","L022",103,0,4,4,107,0.962616822429907,0,0.0373831775700935,0.0373831775700935
"1798",2011,"Bassersdorf","L022",111,3,2,5,116,0.956896551724138,0.0258620689655172,0.0172413793103448,0.0431034482758621
"1799",2012,"Bassersdorf","L022",116,2,2,4,120,0.966666666666667,0.0166666666666667,0.0166666666666667,0.0333333333333333
"1800",2013,"Bassersdorf","L022",117,1,0,1,118,0.991525423728814,0.00847457627118644,0,0.00847457627118644
"1801",2014,"Bassersdorf","L022",129,2,0,2,131,0.984732824427481,0.0152671755725191,0,0.0152671755725191
"1802",2015,"Bassersdorf","L022",110,0,1,1,111,0.990990990990991,0,0.00900900900900901,0.00900900900900901
"1803",2016,"Bassersdorf","L022",115,5,1,6,121,0.950413223140496,0.0413223140495868,0.00826446280991736,0.0495867768595041
"1804",2017,"Bassersdorf","L022",129,5,0,5,134,0.962686567164179,0.0373134328358209,0,0.0373134328358209
"1805",2018,"Bassersdorf","L022",130,3,0,3,133,0.977443609022556,0.0225563909774436,0,0.0225563909774436
"1806",2019,"Bassersdorf","L022",119,6,0,6,125,0.952,0.048,0,0.048
"1807",2020,"Bassersdorf","L022",118,6,0,6,124,0.951612903225806,0.0483870967741935,0,0.0483870967741935
"1808",2021,"Bassersdorf","L022",113,2,0,2,115,0.982608695652174,0.0173913043478261,0,0.0173913043478261
"1809",2022,"Bassersdorf","L022",98,2,0,2,100,0.98,0.02,0,0.02
"1811",2010,"Bülach","L030",140,5,8,13,153,0.915032679738562,0.0326797385620915,0.0522875816993464,0.0849673202614379
"1812",2011,"Bülach","L030",164,0,4,4,168,0.976190476190476,0,0.0238095238095238,0.0238095238095238
"1813",2012,"Bülach","L030",153,1,5,6,159,0.962264150943396,0.00628930817610063,0.0314465408805031,0.0377358490566038
"1814",2013,"Bülach","L030",174,2,3,5,179,0.972067039106145,0.0111731843575419,0.0167597765363128,0.0279329608938547
"1815",2014,"Bülach","L030",187,2,0,2,189,0.989417989417989,0.0105820105820106,0,0.0105820105820106
"1816",2015,"Bülach","L030",163,4,0,4,167,0.976047904191617,0.0239520958083832,0,0.0239520958083832
"1817",2016,"Bülach","L030",187,5,0,5,192,0.973958333333333,0.0260416666666667,0,0.0260416666666667
"1818",2017,"Bülach","L030",205,12,1,13,218,0.940366972477064,0.055045871559633,0.00458715596330275,0.0596330275229358
"1819",2018,"Bülach","L030",211,5,0,5,216,0.976851851851852,0.0231481481481481,0,0.0231481481481481
"1820",2019,"Bülach","L030",230,16,0,16,246,0.934959349593496,0.0650406504065041,0,0.0650406504065041
"1821",2020,"Bülach","L030",229,20,0,20,249,0.919678714859438,0.0803212851405622,0,0.0803212851405622
"1822",2021,"Bülach","L030",225,17,0,17,242,0.929752066115702,0.0702479338842975,0,0.0702479338842975
"1823",2022,"Bülach","L030",240,20,0,20,260,0.923076923076923,0.0769230769230769,0,0.0769230769230769
"1825",2010,"Dietlikon","L052",55,0,6,6,61,0.901639344262295,0,0.0983606557377049,0.0983606557377049
"1826",2011,"Dietlikon","L052",67,0,0,0,67,1,0,0,0
"1827",2012,"Dietlikon","L052",76,1,4,5,81,0.938271604938272,0.0123456790123457,0.0493827160493827,0.0617283950617284
"1828",2013,"Dietlikon","L052",62,2,0,2,64,0.96875,0.03125,0,0.03125
"1829",2014,"Dietlikon","L052",81,0,1,1,82,0.98780487804878,0,0.0121951219512195,0.0121951219512195
"1830",2015,"Dietlikon","L052",81,5,0,5,86,0.941860465116279,0.0581395348837209,0,0.0581395348837209
"1831",2016,"Dietlikon","L052",82,2,0,2,84,0.976190476190476,0.0238095238095238,0,0.0238095238095238
"1832",2017,"Dietlikon","L052",75,0,0,0,75,1,0,0,0
"1833",2018,"Dietlikon","L052",77,3,0,3,80,0.9625,0.0375,0,0.0375
"1834",2019,"Dietlikon","L052",75,4,0,4,79,0.949367088607595,0.0506329113924051,0,0.0506329113924051
"1835",2020,"Dietlikon","L052",64,3,0,3,67,0.955223880597015,0.0447761194029851,0,0.0447761194029851
"1836",2021,"Dietlikon","L052",66,6,0,6,72,0.916666666666667,0.0833333333333333,0,0.0833333333333333
"1837",2022,"Dietlikon","L052",79,5,0,5,84,0.94047619047619,0.0595238095238095,0,0.0595238095238095
"1839",2010,"Eglisau","L062",34,2,5,7,41,0.829268292682927,0.0487804878048781,0.121951219512195,0.170731707317073
"1840",2011,"Eglisau","L062",55,0,2,2,57,0.964912280701754,0,0.0350877192982456,0.0350877192982456
"1841",2012,"Eglisau","L062",44,0,1,1,45,0.977777777777778,0,0.0222222222222222,0.0222222222222222
"1842",2013,"Eglisau","L062",73,0,0,0,73,1,0,0,0
"1843",2014,"Eglisau","L062",69,3,0,3,72,0.958333333333333,0.0416666666666667,0,0.0416666666666667
"1844",2015,"Eglisau","L062",58,2,1,3,61,0.950819672131147,0.0327868852459016,0.0163934426229508,0.0491803278688525
"1845",2016,"Eglisau","L062",72,1,0,1,73,0.986301369863014,0.0136986301369863,0,0.0136986301369863
"1846",2017,"Eglisau","L062",63,2,0,2,65,0.969230769230769,0.0307692307692308,0,0.0307692307692308
"1847",2018,"Eglisau","L062",61,6,0,6,67,0.91044776119403,0.0895522388059701,0,0.0895522388059701
"1848",2019,"Eglisau","L062",52,4,0,4,56,0.928571428571429,0.0714285714285714,0,0.0714285714285714
"1849",2020,"Eglisau","L062",62,9,0,9,71,0.873239436619718,0.126760563380282,0,0.126760563380282
"1850",2021,"Eglisau","L062",59,5,0,5,64,0.921875,0.078125,0,0.078125
"1851",2022,"Eglisau","L062",63,6,1,7,70,0.9,0.0857142857142857,0.0142857142857143,0.1
"1853",2010,"Embrach","L070",101,0,2,2,103,0.980582524271845,0,0.0194174757281553,0.0194174757281553
"1854",2011,"Embrach","L070",100,1,1,2,102,0.980392156862745,0.00980392156862745,0.00980392156862745,0.0196078431372549
"1855",2012,"Embrach","L070",90,1,0,1,91,0.989010989010989,0.010989010989011,0,0.010989010989011
"1856",2013,"Embrach","L070",86,0,5,5,91,0.945054945054945,0,0.0549450549450549,0.0549450549450549
"1857",2014,"Embrach","L070",100,1,1,2,102,0.980392156862745,0.00980392156862745,0.00980392156862745,0.0196078431372549
"1858",2015,"Embrach","L070",105,0,0,0,105,1,0,0,0
"1859",2016,"Embrach","L070",117,1,1,2,119,0.983193277310924,0.00840336134453781,0.00840336134453781,0.0168067226890756
"1860",2017,"Embrach","L070",88,2,0,2,90,0.977777777777778,0.0222222222222222,0,0.0222222222222222
"1861",2018,"Embrach","L070",91,2,0,2,93,0.978494623655914,0.021505376344086,0,0.021505376344086
"1862",2019,"Embrach","L070",90,8,0,8,98,0.918367346938776,0.0816326530612245,0,0.0816326530612245
"1863",2020,"Embrach","L070",91,4,0,4,95,0.957894736842105,0.0421052631578947,0,0.0421052631578947
"1864",2021,"Embrach","L070",99,9,0,9,108,0.916666666666667,0.0833333333333333,0,0.0833333333333333
"1865",2022,"Embrach","L070",90,7,0,7,97,0.927835051546392,0.0721649484536082,0,0.0721649484536082
"1867",2010,"Glattfelden","L092",48,0,0,0,48,1,0,0,0
"1868",2011,"Glattfelden","L092",51,0,1,1,52,0.980769230769231,0,0.0192307692307692,0.0192307692307692
"1869",2012,"Glattfelden","L092",58,3,1,4,62,0.935483870967742,0.0483870967741935,0.0161290322580645,0.0645161290322581
"1870",2013,"Glattfelden","L092",42,0,3,3,45,0.933333333333333,0,0.0666666666666667,0.0666666666666667
"1871",2014,"Glattfelden","L092",55,0,1,1,56,0.982142857142857,0,0.0178571428571429,0.0178571428571429
"1872",2015,"Glattfelden","L092",51,0,0,0,51,1,0,0,0
"1873",2016,"Glattfelden","L092",53,3,0,3,56,0.946428571428571,0.0535714285714286,0,0.0535714285714286
"1874",2017,"Glattfelden","L092",72,2,0,2,74,0.972972972972973,0.027027027027027,0,0.027027027027027
"1875",2018,"Glattfelden","L092",55,1,1,2,57,0.964912280701754,0.0175438596491228,0.0175438596491228,0.0350877192982456
"1876",2019,"Glattfelden","L092",66,3,0,3,69,0.956521739130435,0.0434782608695652,0,0.0434782608695652
"1877",2020,"Glattfelden","L092",53,4,0,4,57,0.929824561403509,0.0701754385964912,0,0.0701754385964912
"1878",2021,"Glattfelden","L092",57,7,0,7,64,0.890625,0.109375,0,0.109375
"1879",2022,"Glattfelden","L092",50,4,0,4,54,0.925925925925926,0.0740740740740741,0,0.0740740740740741
"1881",2010,"Hochfelden","L100",20,1,1,2,22,0.909090909090909,0.0454545454545455,0.0454545454545455,0.0909090909090909
"1882",2011,"Hochfelden","L100",28,2,0,2,30,0.933333333333333,0.0666666666666667,0,0.0666666666666667
"1883",2012,"Hochfelden","L100",30,0,2,2,32,0.9375,0,0.0625,0.0625
"1884",2013,"Hochfelden","L100",24,1,0,1,25,0.96,0.04,0,0.04
"1885",2014,"Hochfelden","L100",27,2,1,3,30,0.9,0.0666666666666667,0.0333333333333333,0.1
"1886",2015,"Hochfelden","L100",19,1,1,2,21,0.904761904761905,0.0476190476190476,0.0476190476190476,0.0952380952380952
"1887",2016,"Hochfelden","L100",16,0,0,0,16,1,0,0,0
"1888",2017,"Hochfelden","L100",22,3,0,3,25,0.88,0.12,0,0.12
"1889",2018,"Hochfelden","L100",18,1,0,1,19,0.947368421052632,0.0526315789473684,0,0.0526315789473684
"1890",2019,"Hochfelden","L100",24,1,0,1,25,0.96,0.04,0,0.04
"1891",2020,"Hochfelden","L100",19,1,0,1,20,0.95,0.05,0,0.05
"1892",2021,"Hochfelden","L100",14,2,0,2,16,0.875,0.125,0,0.125
"1893",2022,"Hochfelden","L100",21,1,0,1,22,0.954545454545455,0.0454545454545455,0,0.0454545454545455
"1895",2010,"Höri","L110",22,0,0,0,22,1,0,0,0
"1896",2011,"Höri","L110",25,0,0,0,25,1,0,0,0
"1897",2012,"Höri","L110",24,0,1,1,25,0.96,0,0.04,0.04
"1898",2013,"Höri","L110",19,0,0,0,19,1,0,0,0
"1899",2014,"Höri","L110",24,0,0,0,24,1,0,0,0
"1900",2015,"Höri","L110",25,0,0,0,25,1,0,0,0
"1901",2016,"Höri","L110",34,1,0,1,35,0.971428571428571,0.0285714285714286,0,0.0285714285714286
"1902",2017,"Höri","L110",26,1,0,1,27,0.962962962962963,0.037037037037037,0,0.037037037037037
"1903",2018,"Höri","L110",24,2,0,2,26,0.923076923076923,0.0769230769230769,0,0.0769230769230769
"1904",2019,"Höri","L110",24,3,0,3,27,0.888888888888889,0.111111111111111,0,0.111111111111111
"1905",2020,"Höri","L110",24,3,0,3,27,0.888888888888889,0.111111111111111,0,0.111111111111111
"1906",2021,"Höri","L110",38,3,0,3,41,0.926829268292683,0.0731707317073171,0,0.0731707317073171
"1907",2022,"Höri","L110",33,1,0,1,34,0.970588235294118,0.0294117647058824,0,0.0294117647058824
"1909",2010,"Kloten","L132",140,0,5,5,145,0.96551724137931,0,0.0344827586206897,0.0344827586206897
"1910",2011,"Kloten","L132",134,0,6,6,140,0.957142857142857,0,0.0428571428571429,0.0428571428571429
"1911",2012,"Kloten","L132",156,0,2,2,158,0.987341772151899,0,0.0126582278481013,0.0126582278481013
"1912",2013,"Kloten","L132",165,0,0,0,165,1,0,0,0
"1913",2014,"Kloten","L132",159,2,2,4,163,0.975460122699387,0.0122699386503067,0.0122699386503067,0.0245398773006135
"1914",2015,"Kloten","L132",156,5,0,5,161,0.968944099378882,0.031055900621118,0,0.031055900621118
"1915",2016,"Kloten","L132",198,5,0,5,203,0.975369458128079,0.0246305418719212,0,0.0246305418719212
"1916",2017,"Kloten","L132",184,4,1,5,189,0.973544973544973,0.0211640211640212,0.00529100529100529,0.0264550264550265
"1917",2018,"Kloten","L132",189,7,1,8,197,0.959390862944162,0.0355329949238579,0.0050761421319797,0.0406091370558376
"1918",2019,"Kloten","L132",194,5,0,5,199,0.974874371859296,0.0251256281407035,0,0.0251256281407035
"1919",2020,"Kloten","L132",168,13,0,13,181,0.92817679558011,0.0718232044198895,0,0.0718232044198895
"1920",2021,"Kloten","L132",185,11,0,11,196,0.943877551020408,0.0561224489795918,0,0.0561224489795918
"1921",2022,"Kloten","L132",209,12,0,12,221,0.945701357466063,0.0542986425339367,0,0.0542986425339367
"1923",2010,"Lufingen","L140",20,0,0,0,20,1,0,0,0
"1924",2011,"Lufingen","L140",38,0,1,1,39,0.974358974358974,0,0.0256410256410256,0.0256410256410256
"1925",2012,"Lufingen","L140",26,0,2,2,28,0.928571428571429,0,0.0714285714285714,0.0714285714285714
"1926",2013,"Lufingen","L140",16,0,4,4,20,0.8,0,0.2,0.2
"1927",2014,"Lufingen","L140",17,0,1,1,18,0.944444444444444,0,0.0555555555555556,0.0555555555555556
"1928",2015,"Lufingen","L140",22,0,1,1,23,0.956521739130435,0,0.0434782608695652,0.0434782608695652
"1929",2016,"Lufingen","L140",23,0,2,2,25,0.92,0,0.08,0.08
"1930",2017,"Lufingen","L140",27,1,1,2,29,0.931034482758621,0.0344827586206897,0.0344827586206897,0.0689655172413793
"1931",2018,"Lufingen","L140",25,1,0,1,26,0.961538461538462,0.0384615384615385,0,0.0384615384615385
"1932",2019,"Lufingen","L140",28,1,0,1,29,0.96551724137931,0.0344827586206897,0,0.0344827586206897
"1933",2020,"Lufingen","L140",27,1,0,1,28,0.964285714285714,0.0357142857142857,0,0.0357142857142857
"1934",2021,"Lufingen","L140",33,2,0,2,35,0.942857142857143,0.0571428571428571,0,0.0571428571428571
"1935",2022,"Lufingen","L140",30,3,0,3,33,0.909090909090909,0.0909090909090909,0,0.0909090909090909
"1937",2010,"Nürensdorf","L152",45,2,4,6,51,0.882352941176471,0.0392156862745098,0.0784313725490196,0.117647058823529
"1938",2011,"Nürensdorf","L152",39,0,4,4,43,0.906976744186046,0,0.0930232558139535,0.0930232558139535
"1939",2012,"Nürensdorf","L152",40,2,2,4,44,0.909090909090909,0.0454545454545455,0.0454545454545455,0.0909090909090909
"1940",2013,"Nürensdorf","L152",46,1,2,3,49,0.938775510204082,0.0204081632653061,0.0408163265306122,0.0612244897959184
"1941",2014,"Nürensdorf","L152",46,0,0,0,46,1,0,0,0
"1942",2015,"Nürensdorf","L152",57,1,0,1,58,0.982758620689655,0.0172413793103448,0,0.0172413793103448
"1943",2016,"Nürensdorf","L152",59,0,1,1,60,0.983333333333333,0,0.0166666666666667,0.0166666666666667
"1944",2017,"Nürensdorf","L152",59,4,0,4,63,0.936507936507937,0.0634920634920635,0,0.0634920634920635
"1945",2018,"Nürensdorf","L152",50,2,0,2,52,0.961538461538462,0.0384615384615385,0,0.0384615384615385
"1946",2019,"Nürensdorf","L152",47,0,0,0,47,1,0,0,0
"1947",2020,"Nürensdorf","L152",41,8,0,8,49,0.836734693877551,0.163265306122449,0,0.163265306122449
"1948",2021,"Nürensdorf","L152",48,6,0,6,54,0.888888888888889,0.111111111111111,0,0.111111111111111
"1949",2022,"Nürensdorf","L152",40,2,0,2,42,0.952380952380952,0.0476190476190476,0,0.0476190476190476
"1951",2010,"Oberembrach","L160",6,0,0,0,6,1,0,0,0
"1952",2011,"Oberembrach","L160",6,0,0,0,6,1,0,0,0
"1953",2012,"Oberembrach","L160",6,0,1,1,7,0.857142857142857,0,0.142857142857143,0.142857142857143
"1954",2013,"Oberembrach","L160",12,1,0,1,13,0.923076923076923,0.0769230769230769,0,0.0769230769230769
"1955",2014,"Oberembrach","L160",7,0,0,0,7,1,0,0,0
"1956",2015,"Oberembrach","L160",6,0,0,0,6,1,0,0,0
"1957",2016,"Oberembrach","L160",8,0,0,0,8,1,0,0,0
"1958",2017,"Oberembrach","L160",8,0,0,0,8,1,0,0,0
"1959",2018,"Oberembrach","L160",9,0,0,0,9,1,0,0,0
"1960",2019,"Oberembrach","L160",7,1,0,1,8,0.875,0.125,0,0.125
"1961",2020,"Oberembrach","L160",10,0,0,0,10,1,0,0,0
"1962",2021,"Oberembrach","L160",12,1,0,1,13,0.923076923076923,0.0769230769230769,0,0.0769230769230769
"1963",2022,"Oberembrach","L160",9,1,0,1,10,0.9,0.1,0,0.1
"1965",2010,"Opfikon","L172",152,1,6,7,159,0.955974842767296,0.00628930817610063,0.0377358490566038,0.0440251572327044
"1966",2011,"Opfikon","L172",148,2,5,7,155,0.954838709677419,0.0129032258064516,0.032258064516129,0.0451612903225806
"1967",2012,"Opfikon","L172",142,0,1,1,143,0.993006993006993,0,0.00699300699300699,0.00699300699300699
"1968",2013,"Opfikon","L172",175,2,1,3,178,0.98314606741573,0.0112359550561798,0.00561797752808989,0.0168539325842697
"1969",2014,"Opfikon","L172",167,1,1,2,169,0.988165680473373,0.00591715976331361,0.00591715976331361,0.0118343195266272
"1970",2015,"Opfikon","L172",224,2,1,3,227,0.986784140969163,0.00881057268722467,0.00440528634361234,0.013215859030837
"1971",2016,"Opfikon","L172",212,5,2,7,219,0.968036529680365,0.0228310502283105,0.0091324200913242,0.0319634703196347
"1972",2017,"Opfikon","L172",222,2,0,2,224,0.991071428571429,0.00892857142857143,0,0.00892857142857143
"1973",2018,"Opfikon","L172",219,5,4,9,228,0.960526315789474,0.0219298245614035,0.0175438596491228,0.0394736842105263
"1974",2019,"Opfikon","L172",236,7,0,7,243,0.97119341563786,0.0288065843621399,0,0.0288065843621399
"1975",2020,"Opfikon","L172",242,8,0,8,250,0.968,0.032,0,0.032
"1976",2021,"Opfikon","L172",246,5,0,5,251,0.9800796812749,0.0199203187250996,0,0.0199203187250996
"1977",2022,"Opfikon","L172",210,6,0,6,216,0.972222222222222,0.0277777777777778,0,0.0277777777777778
"1979",2010,"Rafz","L182",33,1,3,4,37,0.891891891891892,0.027027027027027,0.0810810810810811,0.108108108108108
"1980",2011,"Rafz","L182",33,0,3,3,36,0.916666666666667,0,0.0833333333333333,0.0833333333333333
"1981",2012,"Rafz","L182",30,3,1,4,34,0.882352941176471,0.0882352941176471,0.0294117647058824,0.117647058823529
"1982",2013,"Rafz","L182",43,3,3,6,49,0.877551020408163,0.0612244897959184,0.0612244897959184,0.122448979591837
"1983",2014,"Rafz","L182",40,1,0,1,41,0.975609756097561,0.024390243902439,0,0.024390243902439
"1984",2015,"Rafz","L182",41,0,0,0,41,1,0,0,0
"1985",2016,"Rafz","L182",41,3,0,3,44,0.931818181818182,0.0681818181818182,0,0.0681818181818182
"1986",2017,"Rafz","L182",54,4,0,4,58,0.931034482758621,0.0689655172413793,0,0.0689655172413793
"1987",2018,"Rafz","L182",43,4,0,4,47,0.914893617021277,0.0851063829787234,0,0.0851063829787234
"1988",2019,"Rafz","L182",43,5,0,5,48,0.895833333333333,0.104166666666667,0,0.104166666666667
"1989",2020,"Rafz","L182",46,10,0,10,56,0.821428571428571,0.178571428571429,0,0.178571428571429
"1990",2021,"Rafz","L182",32,7,0,7,39,0.82051282051282,0.179487179487179,0,0.179487179487179
"1991",2022,"Rafz","L182",44,7,0,7,51,0.862745098039216,0.137254901960784,0,0.137254901960784
"1993",2010,"Rorbas-Freienstein-Teufen","L192",42,1,1,2,44,0.954545454545455,0.0227272727272727,0.0227272727272727,0.0454545454545455
"1994",2011,"Rorbas-Freienstein-Teufen","L192",39,0,3,3,42,0.928571428571429,0,0.0714285714285714,0.0714285714285714
"1995",2012,"Rorbas-Freienstein-Teufen","L192",50,2,0,2,52,0.961538461538462,0.0384615384615385,0,0.0384615384615385
"1996",2013,"Rorbas-Freienstein-Teufen","L192",55,2,0,2,57,0.964912280701754,0.0350877192982456,0,0.0350877192982456
"1997",2014,"Rorbas-Freienstein-Teufen","L192",50,2,0,2,52,0.961538461538462,0.0384615384615385,0,0.0384615384615385
"1998",2015,"Rorbas-Freienstein-Teufen","L192",63,1,0,1,64,0.984375,0.015625,0,0.015625
"1999",2016,"Rorbas-Freienstein-Teufen","L192",46,4,0,4,50,0.92,0.08,0,0.08
"2000",2017,"Rorbas-Freienstein-Teufen","L192",68,5,0,5,73,0.931506849315068,0.0684931506849315,0,0.0684931506849315
"2001",2018,"Rorbas-Freienstein-Teufen","L192",53,3,0,3,56,0.946428571428571,0.0535714285714286,0,0.0535714285714286
"2002",2019,"Rorbas-Freienstein-Teufen","L192",63,8,0,8,71,0.887323943661972,0.112676056338028,0,0.112676056338028
"2003",2020,"Rorbas-Freienstein-Teufen","L192",68,3,0,3,71,0.957746478873239,0.0422535211267606,0,0.0422535211267606
"2004",2021,"Rorbas-Freienstein-Teufen","L192",48,4,0,4,52,0.923076923076923,0.0769230769230769,0,0.0769230769230769
"2005",2022,"Rorbas-Freienstein-Teufen","L192",39,7,0,7,46,0.847826086956522,0.152173913043478,0,0.152173913043478
"2007",2010,"Wallisellen","L202",111,1,11,12,123,0.902439024390244,0.00813008130081301,0.0894308943089431,0.0975609756097561
"2008",2011,"Wallisellen","L202",98,1,5,6,104,0.942307692307692,0.00961538461538462,0.0480769230769231,0.0576923076923077
"2009",2012,"Wallisellen","L202",131,1,8,9,140,0.935714285714286,0.00714285714285714,0.0571428571428571,0.0642857142857143
"2010",2013,"Wallisellen","L202",128,0,2,2,130,0.984615384615385,0,0.0153846153846154,0.0153846153846154
"2011",2014,"Wallisellen","L202",153,1,2,3,156,0.980769230769231,0.00641025641025641,0.0128205128205128,0.0192307692307692
"2012",2015,"Wallisellen","L202",173,1,1,2,175,0.988571428571429,0.00571428571428571,0.00571428571428571,0.0114285714285714
"2013",2016,"Wallisellen","L202",142,1,1,2,144,0.986111111111111,0.00694444444444444,0.00694444444444444,0.0138888888888889
"2014",2017,"Wallisellen","L202",148,0,0,0,148,1,0,0,0
"2015",2018,"Wallisellen","L202",152,8,0,8,160,0.95,0.05,0,0.05
"2016",2019,"Wallisellen","L202",143,16,0,16,159,0.89937106918239,0.10062893081761,0,0.10062893081761
"2017",2020,"Wallisellen","L202",165,10,0,10,175,0.942857142857143,0.0571428571428571,0,0.0571428571428571
"2018",2021,"Wallisellen","L202",163,7,0,7,170,0.958823529411765,0.0411764705882353,0,0.0411764705882353
"2019",2022,"Wallisellen","L202",157,3,0,3,160,0.98125,0.01875,0,0.01875
"2021",2010,"Unteres Rafzerfeld","L232",26,2,1,3,29,0.896551724137931,0.0689655172413793,0.0344827586206897,0.103448275862069
"2022",2011,"Unteres Rafzerfeld","L232",25,0,1,1,26,0.961538461538462,0,0.0384615384615385,0.0384615384615385
"2023",2012,"Unteres Rafzerfeld","L232",29,2,0,2,31,0.935483870967742,0.0645161290322581,0,0.0645161290322581
"2024",2013,"Unteres Rafzerfeld","L232",20,3,0,3,23,0.869565217391304,0.130434782608696,0,0.130434782608696
"2025",2014,"Unteres Rafzerfeld","L232",27,1,0,1,28,0.964285714285714,0.0357142857142857,0,0.0357142857142857
"2026",2015,"Unteres Rafzerfeld","L232",29,2,0,2,31,0.935483870967742,0.0645161290322581,0,0.0645161290322581
"2027",2016,"Unteres Rafzerfeld","L232",28,1,0,1,29,0.96551724137931,0.0344827586206897,0,0.0344827586206897
"2028",2017,"Unteres Rafzerfeld","L232",29,3,0,3,32,0.90625,0.09375,0,0.09375
"2029",2018,"Unteres Rafzerfeld","L232",26,2,0,2,28,0.928571428571429,0.0714285714285714,0,0.0714285714285714
"2030",2019,"Unteres Rafzerfeld","L232",39,2,0,2,41,0.951219512195122,0.0487804878048781,0,0.0487804878048781
"2031",2020,"Unteres Rafzerfeld","L232",25,1,0,1,26,0.961538461538462,0.0384615384615385,0,0.0384615384615385
"2032",2021,"Unteres Rafzerfeld","L232",23,2,0,2,25,0.92,0.08,0,0.08
"2033",2022,"Unteres Rafzerfeld","L232",32,5,0,5,37,0.864864864864865,0.135135135135135,0,0.135135135135135
"2035",2010,"Winkel","L240",20,3,0,3,23,0.869565217391304,0.130434782608696,0,0.130434782608696
"2036",2011,"Winkel","L240",22,2,1,3,25,0.88,0.08,0.04,0.12
"2037",2012,"Winkel","L240",35,1,0,1,36,0.972222222222222,0.0277777777777778,0,0.0277777777777778
"2038",2013,"Winkel","L240",29,1,1,2,31,0.935483870967742,0.032258064516129,0.032258064516129,0.0645161290322581
"2039",2014,"Winkel","L240",41,3,1,4,45,0.911111111111111,0.0666666666666667,0.0222222222222222,0.0888888888888889
"2040",2015,"Winkel","L240",24,0,1,1,25,0.96,0,0.04,0.04
"2041",2016,"Winkel","L240",45,0,0,0,45,1,0,0,0
"2042",2017,"Winkel","L240",46,2,1,3,49,0.938775510204082,0.0408163265306122,0.0204081632653061,0.0612244897959184
"2043",2018,"Winkel","L240",39,2,0,2,41,0.951219512195122,0.0487804878048781,0,0.0487804878048781
"2044",2019,"Winkel","L240",41,5,0,5,46,0.891304347826087,0.108695652173913,0,0.108695652173913
"2045",2020,"Winkel","L240",24,9,0,9,33,0.727272727272727,0.272727272727273,0,0.272727272727273
"2046",2021,"Winkel","L240",44,2,0,2,46,0.956521739130435,0.0434782608695652,0,0.0434782608695652
"2047",2022,"Winkel","L240",37,3,0,3,40,0.925,0.075,0,0.075
"2049",2010,"Bachs","M010",2,0,2,2,4,0.5,0,0.5,0.5
"2050",2011,"Bachs","M010",7,0,0,0,7,1,0,0,0
"2051",2012,"Bachs","M010",3,0,1,1,4,0.75,0,0.25,0.25
"2052",2013,"Bachs","M010",5,0,0,0,5,1,0,0,0
"2053",2014,"Bachs","M010",6,0,0,0,6,1,0,0,0
"2054",2015,"Bachs","M010",3,0,0,0,3,1,0,0,0
"2055",2016,"Bachs","M010",2,1,0,1,3,0.666666666666667,0.333333333333333,0,0.333333333333333
"2056",2017,"Bachs","M010",6,1,0,1,7,0.857142857142857,0.142857142857143,0,0.142857142857143
"2057",2018,"Bachs","M010",6,1,0,1,7,0.857142857142857,0.142857142857143,0,0.142857142857143
"2058",2019,"Bachs","M010",6,2,0,2,8,0.75,0.25,0,0.25
"2059",2020,"Bachs","M010",7,2,0,2,9,0.777777777777778,0.222222222222222,0,0.222222222222222
"2060",2021,"Bachs","M010",3,1,0,1,4,0.75,0.25,0,0.25
"2061",2022,"Bachs","M010",9,1,0,1,10,0.9,0.1,0,0.1
"2063",2010,"Boppelsen","M020",20,1,1,2,22,0.909090909090909,0.0454545454545455,0.0454545454545455,0.0909090909090909
"2064",2011,"Boppelsen","M020",11,1,1,2,13,0.846153846153846,0.0769230769230769,0.0769230769230769,0.153846153846154
"2065",2012,"Boppelsen","M020",26,1,0,1,27,0.962962962962963,0.037037037037037,0,0.037037037037037
"2066",2013,"Boppelsen","M020",9,0,0,0,9,1,0,0,0
"2067",2014,"Boppelsen","M020",14,0,0,0,14,1,0,0,0
"2068",2015,"Boppelsen","M020",18,0,0,0,18,1,0,0,0
"2069",2016,"Boppelsen","M020",19,3,0,3,22,0.863636363636364,0.136363636363636,0,0.136363636363636
"2070",2017,"Boppelsen","M020",22,0,0,0,22,1,0,0,0
"2071",2018,"Boppelsen","M020",15,0,0,0,15,1,0,0,0
"2072",2019,"Boppelsen","M020",8,1,0,1,9,0.888888888888889,0.111111111111111,0,0.111111111111111
"2073",2020,"Boppelsen","M020",19,1,0,1,20,0.95,0.05,0,0.05
"2074",2021,"Boppelsen","M020",12,2,0,2,14,0.857142857142857,0.142857142857143,0,0.142857142857143
"2075",2022,"Boppelsen","M020",11,2,0,2,13,0.846153846153846,0.153846153846154,0,0.153846153846154
"2077",2010,"Buchs","M030",51,3,5,8,59,0.864406779661017,0.0508474576271186,0.0847457627118644,0.135593220338983
"2078",2011,"Buchs","M030",56,2,2,4,60,0.933333333333333,0.0333333333333333,0.0333333333333333,0.0666666666666667
"2079",2012,"Buchs","M030",75,2,1,3,78,0.961538461538462,0.0256410256410256,0.0128205128205128,0.0384615384615385
"2080",2013,"Buchs","M030",58,1,1,2,60,0.966666666666667,0.0166666666666667,0.0166666666666667,0.0333333333333333
"2081",2014,"Buchs","M030",63,2,1,3,66,0.954545454545455,0.0303030303030303,0.0151515151515152,0.0454545454545455
"2082",2015,"Buchs","M030",57,3,1,4,61,0.934426229508197,0.0491803278688525,0.0163934426229508,0.0655737704918033
"2083",2016,"Buchs","M030",55,3,1,4,59,0.932203389830508,0.0508474576271186,0.0169491525423729,0.0677966101694915
"2084",2017,"Buchs","M030",58,5,0,5,63,0.920634920634921,0.0793650793650794,0,0.0793650793650794
"2085",2018,"Buchs","M030",59,11,0,11,70,0.842857142857143,0.157142857142857,0,0.157142857142857
"2086",2019,"Buchs","M030",49,9,0,9,58,0.844827586206897,0.155172413793103,0,0.155172413793103
"2087",2020,"Buchs","M030",61,9,0,9,70,0.871428571428571,0.128571428571429,0,0.128571428571429
"2088",2021,"Buchs","M030",57,5,0,5,62,0.919354838709677,0.0806451612903226,0,0.0806451612903226
"2089",2022,"Buchs","M030",63,5,0,5,68,0.926470588235294,0.0735294117647059,0,0.0735294117647059
"2091",2010,"Dällikon","M040",38,1,5,6,44,0.863636363636364,0.0227272727272727,0.113636363636364,0.136363636363636
"2092",2011,"Dällikon","M040",37,0,3,3,40,0.925,0,0.075,0.075
"2093",2012,"Dällikon","M040",39,1,0,1,40,0.975,0.025,0,0.025
"2094",2013,"Dällikon","M040",32,1,4,5,37,0.864864864864865,0.027027027027027,0.108108108108108,0.135135135135135
"2095",2014,"Dällikon","M040",35,1,1,2,37,0.945945945945946,0.027027027027027,0.027027027027027,0.0540540540540541
"2096",2015,"Dällikon","M040",50,0,1,1,51,0.980392156862745,0,0.0196078431372549,0.0196078431372549
"2097",2016,"Dällikon","M040",37,1,1,2,39,0.948717948717949,0.0256410256410256,0.0256410256410256,0.0512820512820513
"2098",2017,"Dällikon","M040",41,1,0,1,42,0.976190476190476,0.0238095238095238,0,0.0238095238095238
"2099",2018,"Dällikon","M040",46,2,0,2,48,0.958333333333333,0.0416666666666667,0,0.0416666666666667
"2100",2019,"Dällikon","M040",57,2,0,2,59,0.966101694915254,0.0338983050847458,0,0.0338983050847458
"2101",2020,"Dällikon","M040",41,5,0,5,46,0.891304347826087,0.108695652173913,0,0.108695652173913
"2102",2021,"Dällikon","M040",50,3,0,3,53,0.943396226415094,0.0566037735849057,0,0.0566037735849057
"2103",2022,"Dällikon","M040",39,1,0,1,40,0.975,0.025,0,0.025
"2105",2010,"Dänikon-Hüttikon","M050",26,0,3,3,29,0.896551724137931,0,0.103448275862069,0.103448275862069
"2106",2011,"Dänikon-Hüttikon","M050",23,0,0,0,23,1,0,0,0
"2107",2012,"Dänikon-Hüttikon","M050",22,0,1,1,23,0.956521739130435,0,0.0434782608695652,0.0434782608695652
"2108",2013,"Dänikon-Hüttikon","M050",23,0,2,2,25,0.92,0,0.08,0.08
"2109",2014,"Dänikon-Hüttikon","M050",32,1,0,1,33,0.96969696969697,0.0303030303030303,0,0.0303030303030303
"2110",2015,"Dänikon-Hüttikon","M050",34,1,0,1,35,0.971428571428571,0.0285714285714286,0,0.0285714285714286
"2111",2016,"Dänikon-Hüttikon","M050",39,1,0,1,40,0.975,0.025,0,0.025
"2112",2017,"Dänikon-Hüttikon","M050",28,3,0,3,31,0.903225806451613,0.0967741935483871,0,0.0967741935483871
"2113",2018,"Dänikon-Hüttikon","M050",40,2,3,5,45,0.888888888888889,0.0444444444444444,0.0666666666666667,0.111111111111111
"2114",2019,"Dänikon-Hüttikon","M050",31,2,0,2,33,0.939393939393939,0.0606060606060606,0,0.0606060606060606
"2115",2020,"Dänikon-Hüttikon","M050",39,6,0,6,45,0.866666666666667,0.133333333333333,0,0.133333333333333
"2116",2021,"Dänikon-Hüttikon","M050",30,4,0,4,34,0.882352941176471,0.117647058823529,0,0.117647058823529
"2117",2022,"Dänikon-Hüttikon","M050",29,0,0,0,29,1,0,0,0
"2119",2010,"Dielsdorf","M060",59,0,0,0,59,1,0,0,0
"2120",2011,"Dielsdorf","M060",48,2,2,4,52,0.923076923076923,0.0384615384615385,0.0384615384615385,0.0769230769230769
"2121",2012,"Dielsdorf","M060",55,0,3,3,58,0.948275862068966,0,0.0517241379310345,0.0517241379310345
"2122",2013,"Dielsdorf","M060",41,1,1,2,43,0.953488372093023,0.0232558139534884,0.0232558139534884,0.0465116279069767
"2123",2014,"Dielsdorf","M060",47,3,3,6,53,0.886792452830189,0.0566037735849057,0.0566037735849057,0.113207547169811
"2124",2015,"Dielsdorf","M060",51,1,1,2,53,0.962264150943396,0.0188679245283019,0.0188679245283019,0.0377358490566038
"2125",2016,"Dielsdorf","M060",58,0,0,0,58,1,0,0,0
"2126",2017,"Dielsdorf","M060",41,2,0,2,43,0.953488372093023,0.0465116279069767,0,0.0465116279069767
"2127",2018,"Dielsdorf","M060",60,5,0,5,65,0.923076923076923,0.0769230769230769,0,0.0769230769230769
"2128",2019,"Dielsdorf","M060",55,6,0,6,61,0.901639344262295,0.0983606557377049,0,0.0983606557377049
"2129",2020,"Dielsdorf","M060",56,6,0,6,62,0.903225806451613,0.0967741935483871,0,0.0967741935483871
"2130",2021,"Dielsdorf","M060",52,6,0,6,58,0.896551724137931,0.103448275862069,0,0.103448275862069
"2131",2022,"Dielsdorf","M060",54,5,0,5,59,0.915254237288136,0.0847457627118644,0,0.0847457627118644
"2133",2010,"Neerach","M080",21,1,1,2,23,0.91304347826087,0.0434782608695652,0.0434782608695652,0.0869565217391304
"2134",2011,"Neerach","M080",19,0,0,0,19,1,0,0,0
"2135",2012,"Neerach","M080",20,2,1,3,23,0.869565217391304,0.0869565217391304,0.0434782608695652,0.130434782608696
"2136",2013,"Neerach","M080",33,1,0,1,34,0.970588235294118,0.0294117647058824,0,0.0294117647058824
"2137",2014,"Neerach","M080",21,1,0,1,22,0.954545454545455,0.0454545454545455,0,0.0454545454545455
"2138",2015,"Neerach","M080",19,5,0,5,24,0.791666666666667,0.208333333333333,0,0.208333333333333
"2139",2016,"Neerach","M080",21,1,0,1,22,0.954545454545455,0.0454545454545455,0,0.0454545454545455
"2140",2017,"Neerach","M080",29,0,0,0,29,1,0,0,0
"2141",2018,"Neerach","M080",20,0,0,0,20,1,0,0,0
"2142",2019,"Neerach","M080",25,1,0,1,26,0.961538461538462,0.0384615384615385,0,0.0384615384615385
"2143",2020,"Neerach","M080",30,2,0,2,32,0.9375,0.0625,0,0.0625
"2144",2021,"Neerach","M080",28,3,0,3,31,0.903225806451613,0.0967741935483871,0,0.0967741935483871
"2145",2022,"Neerach","M080",22,1,0,1,23,0.956521739130435,0.0434782608695652,0,0.0434782608695652
"2147",2010,"Niederglatt","M090",48,2,2,4,52,0.923076923076923,0.0384615384615385,0.0384615384615385,0.0769230769230769
"2148",2011,"Niederglatt","M090",39,1,1,2,41,0.951219512195122,0.024390243902439,0.024390243902439,0.0487804878048781
"2149",2012,"Niederglatt","M090",41,4,1,5,46,0.891304347826087,0.0869565217391304,0.0217391304347826,0.108695652173913
"2150",2013,"Niederglatt","M090",44,3,0,3,47,0.936170212765957,0.0638297872340425,0,0.0638297872340425
"2151",2014,"Niederglatt","M090",44,0,0,0,44,1,0,0,0
"2152",2015,"Niederglatt","M090",35,0,0,0,35,1,0,0,0
"2153",2016,"Niederglatt","M090",54,1,0,1,55,0.981818181818182,0.0181818181818182,0,0.0181818181818182
"2154",2017,"Niederglatt","M090",56,3,0,3,59,0.949152542372881,0.0508474576271186,0,0.0508474576271186
"2155",2018,"Niederglatt","M090",35,4,0,4,39,0.897435897435897,0.102564102564103,0,0.102564102564103
"2156",2019,"Niederglatt","M090",54,2,0,2,56,0.964285714285714,0.0357142857142857,0,0.0357142857142857
"2157",2020,"Niederglatt","M090",46,7,0,7,53,0.867924528301887,0.132075471698113,0,0.132075471698113
"2158",2021,"Niederglatt","M090",41,6,0,6,47,0.872340425531915,0.127659574468085,0,0.127659574468085
"2159",2022,"Niederglatt","M090",42,3,0,3,45,0.933333333333333,0.0666666666666667,0,0.0666666666666667
"2161",2010,"Niederhasli","M100",68,0,0,0,68,1,0,0,0
"2162",2011,"Niederhasli","M100",85,1,0,1,86,0.988372093023256,0.0116279069767442,0,0.0116279069767442
"2163",2012,"Niederhasli","M100",92,1,4,5,97,0.948453608247423,0.0103092783505155,0.0412371134020619,0.0515463917525773
"2164",2013,"Niederhasli","M100",74,3,0,3,77,0.961038961038961,0.038961038961039,0,0.038961038961039
"2165",2014,"Niederhasli","M100",92,2,1,3,95,0.968421052631579,0.0210526315789474,0.0105263157894737,0.0315789473684211
"2166",2015,"Niederhasli","M100",96,6,1,7,103,0.932038834951456,0.058252427184466,0.00970873786407767,0.0679611650485437
"2167",2016,"Niederhasli","M100",86,2,0,2,88,0.977272727272727,0.0227272727272727,0,0.0227272727272727
"2168",2017,"Niederhasli","M100",85,3,0,3,88,0.965909090909091,0.0340909090909091,0,0.0340909090909091
"2169",2018,"Niederhasli","M100",99,7,1,8,107,0.925233644859813,0.0654205607476635,0.00934579439252336,0.0747663551401869
"2170",2019,"Niederhasli","M100",90,11,0,11,101,0.891089108910891,0.108910891089109,0,0.108910891089109
"2171",2020,"Niederhasli","M100",91,6,0,6,97,0.938144329896907,0.0618556701030928,0,0.0618556701030928
"2172",2021,"Niederhasli","M100",104,8,0,8,112,0.928571428571429,0.0714285714285714,0,0.0714285714285714
"2173",2022,"Niederhasli","M100",96,3,0,3,99,0.96969696969697,0.0303030303030303,0,0.0303030303030303
"2175",2010,"Oberglatt","M140",53,0,2,2,55,0.963636363636364,0,0.0363636363636364,0.0363636363636364
"2176",2011,"Oberglatt","M140",76,0,1,1,77,0.987012987012987,0,0.012987012987013,0.012987012987013
"2177",2012,"Oberglatt","M140",56,1,1,2,58,0.96551724137931,0.0172413793103448,0.0172413793103448,0.0344827586206897
"2178",2013,"Oberglatt","M140",56,1,2,3,59,0.949152542372881,0.0169491525423729,0.0338983050847458,0.0508474576271186
"2179",2014,"Oberglatt","M140",70,0,0,0,70,1,0,0,0
"2180",2015,"Oberglatt","M140",86,1,1,2,88,0.977272727272727,0.0113636363636364,0.0113636363636364,0.0227272727272727
"2181",2016,"Oberglatt","M140",84,3,1,4,88,0.954545454545455,0.0340909090909091,0.0113636363636364,0.0454545454545455
"2182",2017,"Oberglatt","M140",87,2,0,2,89,0.97752808988764,0.0224719101123595,0,0.0224719101123595
"2183",2018,"Oberglatt","M140",74,1,1,2,76,0.973684210526316,0.0131578947368421,0.0131578947368421,0.0263157894736842
"2184",2019,"Oberglatt","M140",75,3,0,3,78,0.961538461538462,0.0384615384615385,0,0.0384615384615385
"2185",2020,"Oberglatt","M140",95,1,0,1,96,0.989583333333333,0.0104166666666667,0,0.0104166666666667
"2186",2021,"Oberglatt","M140",63,3,0,3,66,0.954545454545455,0.0454545454545455,0,0.0454545454545455
"2187",2022,"Oberglatt","M140",76,4,0,4,80,0.95,0.05,0,0.05
"2189",2010,"Otelfingen","M150",21,0,0,0,21,1,0,0,0
"2190",2011,"Otelfingen","M150",29,0,0,0,29,1,0,0,0
"2191",2012,"Otelfingen","M150",33,0,0,0,33,1,0,0,0
"2192",2013,"Otelfingen","M150",37,2,0,2,39,0.948717948717949,0.0512820512820513,0,0.0512820512820513
"2193",2014,"Otelfingen","M150",41,0,0,0,41,1,0,0,0
"2194",2015,"Otelfingen","M150",45,1,0,1,46,0.978260869565217,0.0217391304347826,0,0.0217391304347826
"2195",2016,"Otelfingen","M150",51,1,0,1,52,0.980769230769231,0.0192307692307692,0,0.0192307692307692
"2196",2017,"Otelfingen","M150",30,1,0,1,31,0.967741935483871,0.032258064516129,0,0.032258064516129
"2197",2018,"Otelfingen","M150",30,2,0,2,32,0.9375,0.0625,0,0.0625
"2198",2019,"Otelfingen","M150",23,3,0,3,26,0.884615384615385,0.115384615384615,0,0.115384615384615
"2199",2020,"Otelfingen","M150",19,2,0,2,21,0.904761904761905,0.0952380952380952,0,0.0952380952380952
"2200",2021,"Otelfingen","M150",32,5,0,5,37,0.864864864864865,0.135135135135135,0,0.135135135135135
"2201",2022,"Otelfingen","M150",29,4,0,4,33,0.878787878787879,0.121212121212121,0,0.121212121212121
"2203",2010,"Regensberg","M170",3,0,1,1,4,0.75,0,0.25,0.25
"2204",2011,"Regensberg","M170",2,0,3,3,5,0.4,0,0.6,0.6
"2205",2012,"Regensberg","M170",3,0,0,0,3,1,0,0,0
"2206",2013,"Regensberg","M170",3,0,0,0,3,1,0,0,0
"2207",2014,"Regensberg","M170",3,0,0,0,3,1,0,0,0
"2208",2015,"Regensberg","M170",5,0,0,0,5,1,0,0,0
"2209",2016,"Regensberg","M170",3,2,1,3,6,0.5,0.333333333333333,0.166666666666667,0.5
"2210",2017,"Regensberg","M170",2,0,0,0,2,1,0,0,0
"2211",2018,"Regensberg","M170",2,0,0,0,2,1,0,0,0
"2212",2019,"Regensberg","M170",3,0,0,0,3,1,0,0,0
"2213",2020,"Regensberg","M170",9,0,0,0,9,1,0,0,0
"2214",2021,"Regensberg","M170",2,0,0,0,2,1,0,0,0
"2215",2022,"Regensberg","M170",4,0,0,0,4,1,0,0,0
"2217",2010,"Regensdorf","M180",141,1,0,1,142,0.992957746478873,0.00704225352112676,0,0.00704225352112676
"2218",2011,"Regensdorf","M180",161,0,3,3,164,0.981707317073171,0,0.0182926829268293,0.0182926829268293
"2219",2012,"Regensdorf","M180",164,0,4,4,168,0.976190476190476,0,0.0238095238095238,0.0238095238095238
"2220",2013,"Regensdorf","M180",173,2,0,2,175,0.988571428571429,0.0114285714285714,0,0.0114285714285714
"2221",2014,"Regensdorf","M180",189,1,0,1,190,0.994736842105263,0.00526315789473684,0,0.00526315789473684
"2222",2015,"Regensdorf","M180",177,2,2,4,181,0.977900552486188,0.0110497237569061,0.0110497237569061,0.0220994475138122
"2223",2016,"Regensdorf","M180",193,6,1,7,200,0.965,0.03,0.005,0.035
"2224",2017,"Regensdorf","M180",192,4,1,5,197,0.974619289340102,0.0203045685279188,0.0050761421319797,0.0253807106598985
"2225",2018,"Regensdorf","M180",171,2,1,3,174,0.982758620689655,0.0114942528735632,0.00574712643678161,0.0172413793103448
"2226",2019,"Regensdorf","M180",196,11,0,11,207,0.946859903381642,0.0531400966183575,0,0.0531400966183575
"2227",2020,"Regensdorf","M180",185,9,0,9,194,0.95360824742268,0.0463917525773196,0,0.0463917525773196
"2228",2021,"Regensdorf","M180",186,10,0,10,196,0.948979591836735,0.0510204081632653,0,0.0510204081632653
"2229",2022,"Regensdorf","M180",198,9,0,9,207,0.956521739130435,0.0434782608695652,0,0.0434782608695652
"2231",2010,"Rümlang","M200",57,0,0,0,57,1,0,0,0
"2232",2011,"Rümlang","M200",70,2,0,2,72,0.972222222222222,0.0277777777777778,0,0.0277777777777778
"2233",2012,"Rümlang","M200",58,0,1,1,59,0.983050847457627,0,0.0169491525423729,0.0169491525423729
"2234",2013,"Rümlang","M200",66,2,3,5,71,0.929577464788732,0.028169014084507,0.0422535211267606,0.0704225352112676
"2235",2014,"Rümlang","M200",89,0,1,1,90,0.988888888888889,0,0.0111111111111111,0.0111111111111111
"2236",2015,"Rümlang","M200",57,1,1,2,59,0.966101694915254,0.0169491525423729,0.0169491525423729,0.0338983050847458
"2237",2016,"Rümlang","M200",95,6,2,8,103,0.922330097087379,0.058252427184466,0.0194174757281553,0.0776699029126214
"2238",2017,"Rümlang","M200",80,4,5,9,89,0.898876404494382,0.0449438202247191,0.0561797752808989,0.101123595505618
"2239",2018,"Rümlang","M200",96,5,2,7,103,0.932038834951456,0.0485436893203883,0.0194174757281553,0.0679611650485437
"2240",2019,"Rümlang","M200",89,9,0,9,98,0.908163265306122,0.0918367346938776,0,0.0918367346938776
"2241",2020,"Rümlang","M200",106,5,0,5,111,0.954954954954955,0.045045045045045,0,0.045045045045045
"2242",2021,"Rümlang","M200",87,6,0,6,93,0.935483870967742,0.0645161290322581,0,0.0645161290322581
"2243",2022,"Rümlang","M200",85,9,0,9,94,0.904255319148936,0.0957446808510638,0,0.0957446808510638
"2245",2010,"Stadel","M240",19,0,2,2,21,0.904761904761905,0,0.0952380952380952,0.0952380952380952
"2246",2011,"Stadel","M240",19,0,0,0,19,1,0,0,0
"2247",2012,"Stadel","M240",15,2,0,2,17,0.882352941176471,0.117647058823529,0,0.117647058823529
"2248",2013,"Stadel","M240",22,1,0,1,23,0.956521739130435,0.0434782608695652,0,0.0434782608695652
"2249",2014,"Stadel","M240",16,0,0,0,16,1,0,0,0
"2250",2015,"Stadel","M240",22,0,0,0,22,1,0,0,0
"2251",2016,"Stadel","M240",20,2,0,2,22,0.909090909090909,0.0909090909090909,0,0.0909090909090909
"2252",2017,"Stadel","M240",20,1,0,1,21,0.952380952380952,0.0476190476190476,0,0.0476190476190476
"2253",2018,"Stadel","M240",28,0,0,0,28,1,0,0,0
"2254",2019,"Stadel","M240",24,1,0,1,25,0.96,0.04,0,0.04
"2255",2020,"Stadel","M240",26,4,0,4,30,0.866666666666667,0.133333333333333,0,0.133333333333333
"2256",2021,"Stadel","M240",21,1,0,1,22,0.954545454545455,0.0454545454545455,0,0.0454545454545455
"2257",2022,"Stadel","M240",21,0,0,0,21,1,0,0,0
"2259",2010,"Steinmaur","M260",19,0,1,1,20,0.95,0,0.05,0.05
"2260",2011,"Steinmaur","M260",43,1,0,1,44,0.977272727272727,0.0227272727272727,0,0.0227272727272727
"2261",2012,"Steinmaur","M260",30,0,3,3,33,0.909090909090909,0,0.0909090909090909,0.0909090909090909
"2262",2013,"Steinmaur","M260",28,0,1,1,29,0.96551724137931,0,0.0344827586206897,0.0344827586206897
"2263",2014,"Steinmaur","M260",31,0,0,0,31,1,0,0,0
"2264",2015,"Steinmaur","M260",30,2,0,2,32,0.9375,0.0625,0,0.0625
"2265",2016,"Steinmaur","M260",30,2,2,4,34,0.882352941176471,0.0588235294117647,0.0588235294117647,0.117647058823529
"2266",2017,"Steinmaur","M260",36,1,0,1,37,0.972972972972973,0.027027027027027,0,0.027027027027027
"2267",2018,"Steinmaur","M260",40,2,2,4,44,0.909090909090909,0.0454545454545455,0.0454545454545455,0.0909090909090909
"2268",2019,"Steinmaur","M260",32,3,0,3,35,0.914285714285714,0.0857142857142857,0,0.0857142857142857
"2269",2020,"Steinmaur","M260",39,3,0,3,42,0.928571428571429,0.0714285714285714,0,0.0714285714285714
"2270",2021,"Steinmaur","M260",33,1,0,1,34,0.970588235294118,0.0294117647058824,0,0.0294117647058824
"2271",2022,"Steinmaur","M260",29,2,0,2,31,0.935483870967742,0.0645161290322581,0,0.0645161290322581
"2273",2010,"Weiach","M270",4,0,1,1,5,0.8,0,0.2,0.2
"2274",2011,"Weiach","M270",8,1,0,1,9,0.888888888888889,0.111111111111111,0,0.111111111111111
"2275",2012,"Weiach","M270",10,2,0,2,12,0.833333333333333,0.166666666666667,0,0.166666666666667
"2276",2013,"Weiach","M270",8,1,1,2,10,0.8,0.1,0.1,0.2
"2277",2014,"Weiach","M270",14,1,1,2,16,0.875,0.0625,0.0625,0.125
"2278",2015,"Weiach","M270",16,2,0,2,18,0.888888888888889,0.111111111111111,0,0.111111111111111
"2279",2016,"Weiach","M270",15,1,0,1,16,0.9375,0.0625,0,0.0625
"2280",2017,"Weiach","M270",17,0,0,0,17,1,0,0,0
"2281",2018,"Weiach","M270",14,0,0,0,14,1,0,0,0
"2282",2019,"Weiach","M270",24,3,0,3,27,0.888888888888889,0.111111111111111,0,0.111111111111111
"2283",2020,"Weiach","M270",20,3,0,3,23,0.869565217391304,0.130434782608696,0,0.130434782608696
"2284",2021,"Weiach","M270",22,2,0,2,24,0.916666666666667,0.0833333333333333,0,0.0833333333333333
"2285",2022,"Weiach","M270",17,3,0,3,20,0.85,0.15,0,0.15
"2287",2010,"Wehntal","M282",68,5,1,6,74,0.918918918918919,0.0675675675675676,0.0135135135135135,0.0810810810810811
"2288",2011,"Wehntal","M282",55,0,2,2,57,0.964912280701754,0,0.0350877192982456,0.0350877192982456
"2289",2012,"Wehntal","M282",68,2,3,5,73,0.931506849315068,0.0273972602739726,0.0410958904109589,0.0684931506849315
"2290",2013,"Wehntal","M282",75,2,1,3,78,0.961538461538462,0.0256410256410256,0.0128205128205128,0.0384615384615385
"2291",2014,"Wehntal","M282",59,2,4,6,65,0.907692307692308,0.0307692307692308,0.0615384615384615,0.0923076923076923
"2292",2015,"Wehntal","M282",76,1,2,3,79,0.962025316455696,0.0126582278481013,0.0253164556962025,0.0379746835443038
"2293",2016,"Wehntal","M282",52,1,0,1,53,0.981132075471698,0.0188679245283019,0,0.0188679245283019
"2294",2017,"Wehntal","M282",77,4,1,5,82,0.939024390243902,0.0487804878048781,0.0121951219512195,0.0609756097560976
"2295",2018,"Wehntal","M282",62,3,0,3,65,0.953846153846154,0.0461538461538462,0,0.0461538461538462
"2296",2019,"Wehntal","M282",54,5,0,5,59,0.915254237288136,0.0847457627118644,0,0.0847457627118644
"2297",2020,"Wehntal","M282",71,7,0,7,78,0.91025641025641,0.0897435897435897,0,0.0897435897435897
"2298",2021,"Wehntal","M282",75,4,0,4,79,0.949367088607595,0.0506329113924051,0,0.0506329113924051
"2299",2022,"Wehntal","M282",67,4,0,4,71,0.943661971830986,0.0563380281690141,0,0.0563380281690141
"2300",2010,"Kt. Aargau","X700",1,0,0,0,1,1,0,0,0
"2301",2013,"Kt. Aargau","X700",2,0,0,0,2,1,0,0,0
"2302",2016,"Kt. Aargau","X700",5,1,2,3,8,0.625,0.125,0.25,0.375
"2303",2017,"Kt. Aargau","X700",10,0,1,1,11,0.909090909090909,0,0.0909090909090909,0.0909090909090909
"2304",2018,"Kt. Aargau","X700",11,0,0,0,11,1,0,0,0
"2305",2019,"Kt. Aargau","X700",10,0,0,0,10,1,0,0,0
"2306",2020,"Kt. Aargau","X700",10,0,0,0,10,1,0,0,0
"2307",2021,"Kt. Aargau","X700",13,1,0,1,14,0.928571428571429,0.0714285714285714,0,0.0714285714285714
"2308",2022,"Kt. Aargau","X700",11,1,0,1,12,0.916666666666667,0.0833333333333333,0,0.0833333333333333
"2309",2011,"Kt. Zug","X701",1,0,0,0,1,1,0,0,0
"2310",2020,"Kt. Zug","X701",1,0,0,0,1,1,0,0,0
"2311",2018,"Kt. Schwyz","X702",0,1,0,1,1,0,1,0,1
"2312",2022,"Kt. Schwyz","X702",1,0,0,0,1,1,0,0,0
"2313",2010,"Kt. St. Gallen","X703",1,0,0,0,1,1,0,0,0
"2314",2014,"Kt. St. Gallen","X703",1,0,0,0,1,1,0,0,0
"2315",2015,"Kt. St. Gallen","X703",1,1,0,1,2,0.5,0.5,0,0.5
"2316",2016,"Kt. St. Gallen","X703",2,0,0,0,2,1,0,0,0
"2317",2017,"Kt. St. Gallen","X703",4,0,0,0,4,1,0,0,0
"2318",2019,"Kt. St. Gallen","X703",2,0,0,0,2,1,0,0,0
"2319",2022,"Kt. St. Gallen","X703",1,0,0,0,1,1,0,0,0
"2320",2017,"Kt. Thurgau","X704",2,0,0,0,2,1,0,0,0
"2321",2018,"Kt. Thurgau","X704",0,1,0,1,1,0,1,0,1
"2322",2020,"Kt. Thurgau","X704",1,0,0,0,1,1,0,0,0
"2323",2010,"Kt. Schaffhausen","X705",0,0,1,1,1,0,0,1,1
"2324",2017,"Kt. Schaffhausen","X705",1,0,0,0,1,1,0,0,0
"2325",2011,"Kt. Neuenburg","X712",1,0,0,0,1,1,0,0,0
"2326",2013,"Kt. Waadt","X714",1,0,0,0,1,1,0,0,0
"2327",2021,"Kt. Luzern","X721",1,0,0,0,1,1,0,0,0
"2328",2022,"Ausland","X800",1,0,0,0,1,1,0,0,0
"2330",2010,"Kanton Zürich","ZHTO",11458,181,619,800,12258,0.934736498613151,0.0147658671887747,0.0504976341980747,0.0652635013868494
"2331",2011,"Kanton Zürich","ZHTO",11833,179,525,704,12537,0.943846215202999,0.0142777378958283,0.0418760469011725,0.0561537847970009
"2332",2012,"Kanton Zürich","ZHTO",12477,218,417,635,13112,0.951571079926785,0.0166259914582062,0.0318029286150091,0.0484289200732154
"2333",2013,"Kanton Zürich","ZHTO",12777,233,395,628,13405,0.953151809026483,0.0173815740395375,0.0294666169339799,0.0468481909735173
"2334",2014,"Kanton Zürich","ZHTO",13590,257,296,553,14143,0.960899384854698,0.0181715336208725,0.020929081524429,0.0391006151453016
"2335",2015,"Kanton Zürich","ZHTO",13923,355,220,575,14498,0.960339357152711,0.0244861360187612,0.0151745068285281,0.0396606428472893
"2336",2016,"Kanton Zürich","ZHTO",14066,484,167,651,14717,0.955765441326357,0.0328871373241829,0.0113474213494598,0.0442345586736427
"2337",2017,"Kanton Zürich","ZHTO",14021,608,142,750,14771,0.949224832441947,0.0411617358337283,0.00961343172432469,0.0507751675580529
"2338",2018,"Kanton Zürich","ZHTO",14554,761,75,836,15390,0.945679012345679,0.0494476933073424,0.00487329434697856,0.054320987654321
"2339",2019,"Kanton Zürich","ZHTO",14718,985,1,986,15704,0.937213448802853,0.0627228731533367,6.36780438104941e-05,0.0627865511971472
"2340",2020,"Kanton Zürich","ZHTO",14294,1240,2,1242,15536,0.920056642636457,0.0798146240988672,0.000128733264675592,0.0799433573635427
"2341",2021,"Kanton Zürich","ZHTO",14182,1239,2,1241,15423,0.919535758283084,0.0803345652596771,0.000129676457239188,0.0804642417169163
"2342",2022,"Kanton Zürich","ZHTO",14166,1089,3,1092,15258,0.928430987023201,0.0713723948092804,0.000196618167518679,0.0715690129767991
